season,game_id,game_type,week,home_team,away_team,home_score,away_score,game_outcome,score_diff
2018,2018_01_ATL_PHI,REG,1,PHI,ATL,18,12,1,6
2018,2018_01_BUF_BAL,REG,1,BAL,BUF,47,3,1,44
2018,2018_01_PIT_CLE,REG,1,CLE,PIT,21,21,0.5,0
2018,2018_01_CIN_IND,REG,1,IND,CIN,23,34,0,-11
2018,2018_01_TEN_MIA,REG,1,MIA,TEN,27,20,1,7
2018,2018_01_SF_MIN,REG,1,MIN,SF,24,16,1,8
2018,2018_01_HOU_NE,REG,1,NE,HOU,27,20,1,7
2018,2018_01_TB_NO,REG,1,NO,TB,40,48,0,-8
2018,2018_01_JAX_NYG,REG,1,NYG,JAX,15,20,0,-5
2018,2018_01_KC_LAC,REG,1,LAC,KC,28,38,0,-10
2018,2018_01_WAS_ARI,REG,1,ARI,WAS,6,24,0,-18
2018,2018_01_DAL_CAR,REG,1,CAR,DAL,16,8,1,8
2018,2018_01_SEA_DEN,REG,1,DEN,SEA,27,24,1,3
2018,2018_01_CHI_GB,REG,1,GB,CHI,24,23,1,1
2018,2018_01_NYJ_DET,REG,1,DET,NYJ,17,48,0,-31
2018,2018_01_LA_OAK,REG,1,OAK,LA,13,33,0,-20
2018,2018_02_BAL_CIN,REG,2,CIN,BAL,34,23,1,11
2018,2018_02_CAR_ATL,REG,2,ATL,CAR,31,24,1,7
2018,2018_02_LAC_BUF,REG,2,BUF,LAC,20,31,0,-11
2018,2018_02_MIN_GB,REG,2,GB,MIN,29,29,0.5,0
2018,2018_02_CLE_NO,REG,2,NO,CLE,21,18,1,3
2018,2018_02_MIA_NYJ,REG,2,NYJ,MIA,12,20,0,-8
2018,2018_02_KC_PIT,REG,2,PIT,KC,37,42,0,-5
2018,2018_02_PHI_TB,REG,2,TB,PHI,27,21,1,6
2018,2018_02_HOU_TEN,REG,2,TEN,HOU,20,17,1,3
2018,2018_02_IND_WAS,REG,2,WAS,IND,9,21,0,-12
2018,2018_02_ARI_LA,REG,2,LA,ARI,34,0,1,34
2018,2018_02_DET_SF,REG,2,SF,DET,30,27,1,3
2018,2018_02_OAK_DEN,REG,2,DEN,OAK,20,19,1,1
2018,2018_02_NE_JAX,REG,2,JAX,NE,31,20,1,11
2018,2018_02_NYG_DAL,REG,2,DAL,NYG,20,13,1,7
2018,2018_02_SEA_CHI,REG,2,CHI,SEA,24,17,1,7
2018,2018_03_NYJ_CLE,REG,3,CLE,NYJ,21,17,1,4
2018,2018_03_NO_ATL,REG,3,ATL,NO,37,43,0,-6
2018,2018_03_DEN_BAL,REG,3,BAL,DEN,27,14,1,13
2018,2018_03_CIN_CAR,REG,3,CAR,CIN,31,21,1,10
2018,2018_03_NYG_HOU,REG,3,HOU,NYG,22,27,0,-5
2018,2018_03_TEN_JAX,REG,3,JAX,TEN,6,9,0,-3
2018,2018_03_SF_KC,REG,3,KC,SF,38,27,1,11
2018,2018_03_OAK_MIA,REG,3,MIA,OAK,28,20,1,8
2018,2018_03_BUF_MIN,REG,3,MIN,BUF,6,27,0,-21
2018,2018_03_IND_PHI,REG,3,PHI,IND,20,16,1,4
2018,2018_03_GB_WAS,REG,3,WAS,GB,31,17,1,14
2018,2018_03_LAC_LA,REG,3,LA,LAC,35,23,1,12
2018,2018_03_CHI_ARI,REG,3,ARI,CHI,14,16,0,-2
2018,2018_03_DAL_SEA,REG,3,SEA,DAL,24,13,1,11
2018,2018_03_NE_DET,REG,3,DET,NE,26,10,1,16
2018,2018_03_PIT_TB,REG,3,TB,PIT,27,30,0,-3
2018,2018_04_MIN_LA,REG,4,LA,MIN,38,31,1,7
2018,2018_04_CIN_ATL,REG,4,ATL,CIN,36,37,0,-1
2018,2018_04_TB_CHI,REG,4,CHI,TB,48,10,1,38
2018,2018_04_DET_DAL,REG,4,DAL,DET,26,24,1,2
2018,2018_04_BUF_GB,REG,4,GB,BUF,22,0,1,22
2018,2018_04_HOU_IND,REG,4,IND,HOU,34,37,0,-3
2018,2018_04_NYJ_JAX,REG,4,JAX,NYJ,31,12,1,19
2018,2018_04_MIA_NE,REG,4,NE,MIA,38,7,1,31
2018,2018_04_PHI_TEN,REG,4,TEN,PHI,26,23,1,3
2018,2018_04_SEA_ARI,REG,4,ARI,SEA,17,20,0,-3
2018,2018_04_CLE_OAK,REG,4,OAK,CLE,45,42,1,3
2018,2018_04_SF_LAC,REG,4,LAC,SF,29,27,1,2
2018,2018_04_NO_NYG,REG,4,NYG,NO,18,33,0,-15
2018,2018_04_BAL_PIT,REG,4,PIT,BAL,14,26,0,-12
2018,2018_04_KC_DEN,REG,4,DEN,KC,23,27,0,-4
2018,2018_05_IND_NE,REG,5,NE,IND,38,24,1,14
2018,2018_05_TEN_BUF,REG,5,BUF,TEN,13,12,1,1
2018,2018_05_NYG_CAR,REG,5,CAR,NYG,33,31,1,2
2018,2018_05_MIA_CIN,REG,5,CIN,MIA,27,17,1,10
2018,2018_05_BAL_CLE,REG,5,CLE,BAL,12,9,1,3
2018,2018_05_GB_DET,REG,5,DET,GB,31,23,1,8
2018,2018_05_JAX_KC,REG,5,KC,JAX,30,14,1,16
2018,2018_05_DEN_NYJ,REG,5,NYJ,DEN,34,16,1,18
2018,2018_05_ATL_PIT,REG,5,PIT,ATL,41,17,1,24
2018,2018_05_OAK_LAC,REG,5,LAC,OAK,26,10,1,16
2018,2018_05_MIN_PHI,REG,5,PHI,MIN,21,23,0,-2
2018,2018_05_LA_SEA,REG,5,SEA,LA,31,33,0,-2
2018,2018_05_ARI_SF,REG,5,SF,ARI,18,28,0,-10
2018,2018_05_DAL_HOU,REG,5,HOU,DAL,19,16,1,3
2018,2018_05_WAS_NO,REG,5,NO,WAS,43,19,1,24
2018,2018_06_PHI_NYG,REG,6,NYG,PHI,13,34,0,-21
2018,2018_06_TB_ATL,REG,6,ATL,TB,34,29,1,5
2018,2018_06_PIT_CIN,REG,6,CIN,PIT,21,28,0,-7
2018,2018_06_LAC_CLE,REG,6,CLE,LAC,14,38,0,-24
2018,2018_06_BUF_HOU,REG,6,HOU,BUF,20,13,1,7
2018,2018_06_CHI_MIA,REG,6,MIA,CHI,31,28,1,3
2018,2018_06_ARI_MIN,REG,6,MIN,ARI,27,17,1,10
2018,2018_06_IND_NYJ,REG,6,NYJ,IND,42,34,1,8
2018,2018_06_SEA_OAK,REG,6,OAK,SEA,3,27,0,-24
2018,2018_06_CAR_WAS,REG,6,WAS,CAR,23,17,1,6
2018,2018_06_LA_DEN,REG,6,DEN,LA,20,23,0,-3
2018,2018_06_JAX_DAL,REG,6,DAL,JAX,40,7,1,33
2018,2018_06_BAL_TEN,REG,6,TEN,BAL,0,21,0,-21
2018,2018_06_KC_NE,REG,6,NE,KC,43,40,1,3
2018,2018_06_SF_GB,REG,6,GB,SF,33,30,1,3
2018,2018_07_DEN_ARI,REG,7,ARI,DEN,10,45,0,-35
2018,2018_07_NE_CHI,REG,7,CHI,NE,31,38,0,-7
2018,2018_07_BUF_IND,REG,7,IND,BUF,37,5,1,32
2018,2018_07_HOU_JAX,REG,7,JAX,HOU,7,20,0,-13
2018,2018_07_DET_MIA,REG,7,MIA,DET,21,32,0,-11
2018,2018_07_MIN_NYJ,REG,7,NYJ,MIN,17,37,0,-20
2018,2018_07_CAR_PHI,REG,7,PHI,CAR,17,21,0,-4
2018,2018_07_CLE_TB,REG,7,TB,CLE,26,23,1,3
2018,2018_07_NO_BAL,REG,7,BAL,NO,23,24,0,-1
2018,2018_07_LA_SF,REG,7,SF,LA,10,39,0,-29
2018,2018_07_DAL_WAS,REG,7,WAS,DAL,20,17,1,3
2018,2018_07_CIN_KC,REG,7,KC,CIN,45,10,1,35
2018,2018_07_TEN_LAC,REG,7,LAC,TEN,20,19,1,1
2018,2018_07_NYG_ATL,REG,7,ATL,NYG,23,20,1,3
2018,2018_08_MIA_HOU,REG,8,HOU,MIA,42,23,1,19
2018,2018_08_BAL_CAR,REG,8,CAR,BAL,36,21,1,15
2018,2018_08_NYJ_CHI,REG,8,CHI,NYJ,24,10,1,14
2018,2018_08_TB_CIN,REG,8,CIN,TB,37,34,1,3
2018,2018_08_SEA_DET,REG,8,DET,SEA,14,28,0,-14
2018,2018_08_DEN_KC,REG,8,KC,DEN,30,23,1,7
2018,2018_08_WAS_NYG,REG,8,NYG,WAS,13,20,0,-7
2018,2018_08_CLE_PIT,REG,8,PIT,CLE,33,18,1,15
2018,2018_08_IND_OAK,REG,8,OAK,IND,28,42,0,-14
2018,2018_08_SF_ARI,REG,8,ARI,SF,18,15,1,3
2018,2018_08_GB_LA,REG,8,LA,GB,29,27,1,2
2018,2018_08_NO_MIN,REG,8,MIN,NO,20,30,0,-10
2018,2018_08_PHI_JAX,REG,8,JAX,PHI,18,24,0,-6
2018,2018_08_NE_BUF,REG,8,BUF,NE,6,25,0,-19
2018,2018_09_OAK_SF,REG,9,SF,OAK,34,3,1,31
2018,2018_09_PIT_BAL,REG,9,BAL,PIT,16,23,0,-7
2018,2018_09_CHI_BUF,REG,9,BUF,CHI,9,41,0,-32
2018,2018_09_TB_CAR,REG,9,CAR,TB,42,28,1,14
2018,2018_09_KC_CLE,REG,9,CLE,KC,21,37,0,-16
2018,2018_09_NYJ_MIA,REG,9,MIA,NYJ,13,6,1,7
2018,2018_09_DET_MIN,REG,9,MIN,DET,24,9,1,15
2018,2018_09_ATL_WAS,REG,9,WAS,ATL,14,38,0,-24
2018,2018_09_HOU_DEN,REG,9,DEN,HOU,17,19,0,-2
2018,2018_09_LAC_SEA,REG,9,SEA,LAC,17,25,0,-8
2018,2018_09_LA_NO,REG,9,NO,LA,45,35,1,10
2018,2018_09_GB_NE,REG,9,NE,GB,31,17,1,14
2018,2018_09_TEN_DAL,REG,9,DAL,TEN,14,28,0,-14
2018,2018_10_CAR_PIT,REG,10,PIT,CAR,52,21,1,31
2018,2018_10_DET_CHI,REG,10,CHI,DET,34,22,1,12
2018,2018_10_NO_CIN,REG,10,CIN,NO,14,51,0,-37
2018,2018_10_ATL_CLE,REG,10,CLE,ATL,28,16,1,12
2018,2018_10_JAX_IND,REG,10,IND,JAX,29,26,1,3
2018,2018_10_ARI_KC,REG,10,KC,ARI,26,14,1,12
2018,2018_10_BUF_NYJ,REG,10,NYJ,BUF,10,41,0,-31
2018,2018_10_WAS_TB,REG,10,TB,WAS,3,16,0,-13
2018,2018_10_NE_TEN,REG,10,TEN,NE,34,10,1,24
2018,2018_10_LAC_OAK,REG,10,OAK,LAC,6,20,0,-14
2018,2018_10_MIA_GB,REG,10,GB,MIA,31,12,1,19
2018,2018_10_SEA_LA,REG,10,LA,SEA,36,31,1,5
2018,2018_10_DAL_PHI,REG,10,PHI,DAL,20,27,0,-7
2018,2018_10_NYG_SF,REG,10,SF,NYG,23,27,0,-4
2018,2018_11_GB_SEA,REG,11,SEA,GB,27,24,1,3
2018,2018_11_DAL_ATL,REG,11,ATL,DAL,19,22,0,-3
2018,2018_11_CIN_BAL,REG,11,BAL,CIN,24,21,1,3
2018,2018_11_CAR_DET,REG,11,DET,CAR,20,19,1,1
2018,2018_11_TEN_IND,REG,11,IND,TEN,38,10,1,28
2018,2018_11_PIT_JAX,REG,11,JAX,PIT,16,20,0,-4
2018,2018_11_TB_NYG,REG,11,NYG,TB,38,35,1,3
2018,2018_11_HOU_WAS,REG,11,WAS,HOU,21,23,0,-2
2018,2018_11_OAK_ARI,REG,11,ARI,OAK,21,23,0,-2
2018,2018_11_DEN_LAC,REG,11,LAC,DEN,22,23,0,-1
2018,2018_11_PHI_NO,REG,11,NO,PHI,48,7,1,41
2018,2018_11_MIN_CHI,REG,11,CHI,MIN,25,20,1,5
2018,2018_11_KC_LA,REG,11,LA,KC,54,51,1,3
2018,2018_12_CHI_DET,REG,12,DET,CHI,16,23,0,-7
2018,2018_12_WAS_DAL,REG,12,DAL,WAS,31,23,1,8
2018,2018_12_ATL_NO,REG,12,NO,ATL,31,17,1,14
2018,2018_12_OAK_BAL,REG,12,BAL,OAK,34,17,1,17
2018,2018_12_JAX_BUF,REG,12,BUF,JAX,24,21,1,3
2018,2018_12_SEA_CAR,REG,12,CAR,SEA,27,30,0,-3
2018,2018_12_CLE_CIN,REG,12,CIN,CLE,20,35,0,-15
2018,2018_12_NE_NYJ,REG,12,NYJ,NE,13,27,0,-14
2018,2018_12_NYG_PHI,REG,12,PHI,NYG,25,22,1,3
2018,2018_12_SF_TB,REG,12,TB,SF,27,9,1,18
2018,2018_12_ARI_LAC,REG,12,LAC,ARI,45,10,1,35
2018,2018_12_PIT_DEN,REG,12,DEN,PIT,24,17,1,7
2018,2018_12_MIA_IND,REG,12,IND,MIA,27,24,1,3
2018,2018_12_GB_MIN,REG,12,MIN,GB,24,17,1,7
2018,2018_12_TEN_HOU,REG,12,HOU,TEN,34,17,1,17
2018,2018_13_NO_DAL,REG,13,DAL,NO,13,10,1,3
2018,2018_13_BAL_ATL,REG,13,ATL,BAL,16,26,0,-10
2018,2018_13_DEN_CIN,REG,13,CIN,DEN,10,24,0,-14
2018,2018_13_LA_DET,REG,13,DET,LA,16,30,0,-14
2018,2018_13_ARI_GB,REG,13,GB,ARI,17,20,0,-3
2018,2018_13_CLE_HOU,REG,13,HOU,CLE,29,13,1,16
2018,2018_13_IND_JAX,REG,13,JAX,IND,6,0,1,6
2018,2018_13_BUF_MIA,REG,13,MIA,BUF,21,17,1,4
2018,2018_13_CHI_NYG,REG,13,NYG,CHI,30,27,1,3
2018,2018_13_CAR_TB,REG,13,TB,CAR,24,17,1,7
2018,2018_13_KC_OAK,REG,13,OAK,KC,33,40,0,-7
2018,2018_13_NYJ_TEN,REG,13,TEN,NYJ,26,22,1,4
2018,2018_13_MIN_NE,REG,13,NE,MIN,24,10,1,14
2018,2018_13_SF_SEA,REG,13,SEA,SF,43,16,1,27
2018,2018_13_LAC_PIT,REG,13,PIT,LAC,30,33,0,-3
2018,2018_13_WAS_PHI,REG,13,PHI,WAS,28,13,1,15
2018,2018_14_JAX_TEN,REG,14,TEN,JAX,30,9,1,21
2018,2018_14_NYJ_BUF,REG,14,BUF,NYJ,23,27,0,-4
2018,2018_14_CAR_CLE,REG,14,CLE,CAR,26,20,1,6
2018,2018_14_ATL_GB,REG,14,GB,ATL,34,20,1,14
2018,2018_14_IND_HOU,REG,14,HOU,IND,21,24,0,-3
2018,2018_14_BAL_KC,REG,14,KC,BAL,27,24,1,3
2018,2018_14_NE_MIA,REG,14,MIA,NE,34,33,1,1
2018,2018_14_NO_TB,REG,14,TB,NO,14,28,0,-14
2018,2018_14_NYG_WAS,REG,14,WAS,NYG,16,40,0,-24
2018,2018_14_CIN_LAC,REG,14,LAC,CIN,26,21,1,5
2018,2018_14_DEN_SF,REG,14,SF,DEN,20,14,1,6
2018,2018_14_DET_ARI,REG,14,ARI,DET,3,17,0,-14
2018,2018_14_PHI_DAL,REG,14,DAL,PHI,29,23,1,6
2018,2018_14_PIT_OAK,REG,14,OAK,PIT,24,21,1,3
2018,2018_14_LA_CHI,REG,14,CHI,LA,15,6,1,9
2018,2018_14_MIN_SEA,REG,14,SEA,MIN,21,7,1,14
2018,2018_15_LAC_KC,REG,15,KC,LAC,28,29,0,-1
2018,2018_15_HOU_NYJ,REG,15,NYJ,HOU,22,29,0,-7
2018,2018_15_CLE_DEN,REG,15,DEN,CLE,16,17,0,-1
2018,2018_15_ARI_ATL,REG,15,ATL,ARI,40,14,1,26
2018,2018_15_TB_BAL,REG,15,BAL,TB,20,12,1,8
2018,2018_15_DET_BUF,REG,15,BUF,DET,14,13,1,1
2018,2018_15_GB_CHI,REG,15,CHI,GB,24,17,1,7
2018,2018_15_OAK_CIN,REG,15,CIN,OAK,30,16,1,14
2018,2018_15_DAL_IND,REG,15,IND,DAL,23,0,1,23
2018,2018_15_WAS_JAX,REG,15,JAX,WAS,13,16,0,-3
2018,2018_15_MIA_MIN,REG,15,MIN,MIA,41,17,1,24
2018,2018_15_TEN_NYG,REG,15,NYG,TEN,0,17,0,-17
2018,2018_15_SEA_SF,REG,15,SF,SEA,26,23,1,3
2018,2018_15_NE_PIT,REG,15,PIT,NE,17,10,1,7
2018,2018_15_PHI_LA,REG,15,LA,PHI,23,30,0,-7
2018,2018_15_NO_CAR,REG,15,CAR,NO,9,12,0,-3
2018,2018_16_WAS_TEN,REG,16,TEN,WAS,25,16,1,9
2018,2018_16_BAL_LAC,REG,16,LAC,BAL,10,22,0,-12
2018,2018_16_ATL_CAR,REG,16,CAR,ATL,10,24,0,-14
2018,2018_16_CIN_CLE,REG,16,CLE,CIN,26,18,1,8
2018,2018_16_TB_DAL,REG,16,DAL,TB,27,20,1,7
2018,2018_16_MIN_DET,REG,16,DET,MIN,9,27,0,-18
2018,2018_16_NYG_IND,REG,16,IND,NYG,28,27,1,1
2018,2018_16_JAX_MIA,REG,16,MIA,JAX,7,17,0,-10
2018,2018_16_BUF_NE,REG,16,NE,BUF,24,12,1,12
2018,2018_16_GB_NYJ,REG,16,NYJ,GB,38,44,0,-6
2018,2018_16_HOU_PHI,REG,16,PHI,HOU,32,30,1,2
2018,2018_16_LA_ARI,REG,16,ARI,LA,9,31,0,-22
2018,2018_16_CHI_SF,REG,16,SF,CHI,9,14,0,-5
2018,2018_16_PIT_NO,REG,16,NO,PIT,31,28,1,3
2018,2018_16_KC_SEA,REG,16,SEA,KC,38,31,1,7
2018,2018_16_DEN_OAK,REG,16,OAK,DEN,27,14,1,13
2018,2018_17_MIA_BUF,REG,17,BUF,MIA,42,17,1,25
2018,2018_17_DET_GB,REG,17,GB,DET,0,31,0,-31
2018,2018_17_JAX_HOU,REG,17,HOU,JAX,20,3,1,17
2018,2018_17_NYJ_NE,REG,17,NE,NYJ,38,3,1,35
2018,2018_17_CAR_NO,REG,17,NO,CAR,14,33,0,-19
2018,2018_17_DAL_NYG,REG,17,NYG,DAL,35,36,0,-1
2018,2018_17_ATL_TB,REG,17,TB,ATL,32,34,0,-2
2018,2018_17_CLE_BAL,REG,17,BAL,CLE,26,24,1,2
2018,2018_17_LAC_DEN,REG,17,DEN,LAC,9,23,0,-14
2018,2018_17_OAK_KC,REG,17,KC,OAK,35,3,1,32
2018,2018_17_SF_LA,REG,17,LA,SF,48,32,1,16
2018,2018_17_CHI_MIN,REG,17,MIN,CHI,10,24,0,-14
2018,2018_17_CIN_PIT,REG,17,PIT,CIN,16,13,1,3
2018,2018_17_ARI_SEA,REG,17,SEA,ARI,27,24,1,3
2018,2018_17_PHI_WAS,REG,17,WAS,PHI,0,24,0,-24
2018,2018_17_IND_TEN,REG,17,TEN,IND,17,33,0,-16
2018,2018_18_IND_HOU,WC,18,HOU,IND,7,21,0,-14
2018,2018_18_SEA_DAL,WC,18,DAL,SEA,24,22,1,2
2018,2018_18_LAC_BAL,WC,18,BAL,LAC,17,23,0,-6
2018,2018_18_PHI_CHI,WC,18,CHI,PHI,15,16,0,-1
2018,2018_19_IND_KC,DIV,19,KC,IND,31,13,1,18
2018,2018_19_DAL_LA,DIV,19,LA,DAL,30,22,1,8
2018,2018_19_LAC_NE,DIV,19,NE,LAC,41,28,1,13
2018,2018_19_PHI_NO,DIV,19,NO,PHI,20,14,1,6
2018,2018_20_LA_NO,CON,20,NO,LA,23,26,0,-3
2018,2018_20_NE_KC,CON,20,KC,NE,31,37,0,-6
2018,2018_21_NE_LA,SB,21,LA,NE,3,13,0,-10
2019,2019_01_GB_CHI,REG,1,CHI,GB,3,10,0,-7
2019,2019_01_LA_CAR,REG,1,CAR,LA,27,30,0,-3
2019,2019_01_TEN_CLE,REG,1,CLE,TEN,13,43,0,-30
2019,2019_01_KC_JAX,REG,1,JAX,KC,26,40,0,-14
2019,2019_01_BAL_MIA,REG,1,MIA,BAL,10,59,0,-49
2019,2019_01_ATL_MIN,REG,1,MIN,ATL,28,12,1,16
2019,2019_01_BUF_NYJ,REG,1,NYJ,BUF,16,17,0,-1
2019,2019_01_WAS_PHI,REG,1,PHI,WAS,32,27,1,5
2019,2019_01_IND_LAC,REG,1,LAC,IND,30,24,1,6
2019,2019_01_CIN_SEA,REG,1,SEA,CIN,21,20,1,1
2019,2019_01_DET_ARI,REG,1,ARI,DET,27,27,0.5,0
2019,2019_01_NYG_DAL,REG,1,DAL,NYG,35,17,1,18
2019,2019_01_SF_TB,REG,1,TB,SF,17,31,0,-14
2019,2019_01_PIT_NE,REG,1,NE,PIT,33,3,1,30
2019,2019_01_HOU_NO,REG,1,NO,HOU,30,28,1,2
2019,2019_01_DEN_OAK,REG,1,OAK,DEN,24,16,1,8
2019,2019_02_TB_CAR,REG,2,CAR,TB,14,20,0,-6
2019,2019_02_ARI_BAL,REG,2,BAL,ARI,23,17,1,6
2019,2019_02_SF_CIN,REG,2,CIN,SF,17,41,0,-24
2019,2019_02_LAC_DET,REG,2,DET,LAC,13,10,1,3
2019,2019_02_MIN_GB,REG,2,GB,MIN,21,16,1,5
2019,2019_02_JAX_HOU,REG,2,HOU,JAX,13,12,1,1
2019,2019_02_NE_MIA,REG,2,MIA,NE,0,43,0,-43
2019,2019_02_BUF_NYG,REG,2,NYG,BUF,14,28,0,-14
2019,2019_02_SEA_PIT,REG,2,PIT,SEA,26,28,0,-2
2019,2019_02_IND_TEN,REG,2,TEN,IND,17,19,0,-2
2019,2019_02_DAL_WAS,REG,2,WAS,DAL,21,31,0,-10
2019,2019_02_KC_OAK,REG,2,OAK,KC,10,28,0,-18
2019,2019_02_CHI_DEN,REG,2,DEN,CHI,14,16,0,-2
2019,2019_02_NO_LA,REG,2,LA,NO,27,9,1,18
2019,2019_02_PHI_ATL,REG,2,ATL,PHI,24,20,1,4
2019,2019_02_CLE_NYJ,REG,2,NYJ,CLE,3,23,0,-20
2019,2019_03_TEN_JAX,REG,3,JAX,TEN,20,7,1,13
2019,2019_03_CIN_BUF,REG,3,BUF,CIN,21,17,1,4
2019,2019_03_MIA_DAL,REG,3,DAL,MIA,31,6,1,25
2019,2019_03_DEN_GB,REG,3,GB,DEN,27,16,1,11
2019,2019_03_ATL_IND,REG,3,IND,ATL,27,24,1,3
2019,2019_03_BAL_KC,REG,3,KC,BAL,33,28,1,5
2019,2019_03_OAK_MIN,REG,3,MIN,OAK,34,14,1,20
2019,2019_03_NYJ_NE,REG,3,NE,NYJ,30,14,1,16
2019,2019_03_DET_PHI,REG,3,PHI,DET,24,27,0,-3
2019,2019_03_CAR_ARI,REG,3,ARI,CAR,20,38,0,-18
2019,2019_03_NYG_TB,REG,3,TB,NYG,31,32,0,-1
2019,2019_03_HOU_LAC,REG,3,LAC,HOU,20,27,0,-7
2019,2019_03_NO_SEA,REG,3,SEA,NO,27,33,0,-6
2019,2019_03_PIT_SF,REG,3,SF,PIT,24,20,1,4
2019,2019_03_LA_CLE,REG,3,CLE,LA,13,20,0,-7
2019,2019_03_CHI_WAS,REG,3,WAS,CHI,15,31,0,-16
2019,2019_04_PHI_GB,REG,4,GB,PHI,27,34,0,-7
2019,2019_04_TEN_ATL,REG,4,ATL,TEN,10,24,0,-14
2019,2019_04_CLE_BAL,REG,4,BAL,CLE,25,40,0,-15
2019,2019_04_NE_BUF,REG,4,BUF,NE,10,16,0,-6
2019,2019_04_KC_DET,REG,4,DET,KC,30,34,0,-4
2019,2019_04_CAR_HOU,REG,4,HOU,CAR,10,16,0,-6
2019,2019_04_OAK_IND,REG,4,IND,OAK,24,31,0,-7
2019,2019_04_LAC_MIA,REG,4,MIA,LAC,10,30,0,-20
2019,2019_04_WAS_NYG,REG,4,NYG,WAS,24,3,1,21
2019,2019_04_SEA_ARI,REG,4,ARI,SEA,10,27,0,-17
2019,2019_04_TB_LA,REG,4,LA,TB,40,55,0,-15
2019,2019_04_MIN_CHI,REG,4,CHI,MIN,16,6,1,10
2019,2019_04_JAX_DEN,REG,4,DEN,JAX,24,26,0,-2
2019,2019_04_DAL_NO,REG,4,NO,DAL,12,10,1,2
2019,2019_04_CIN_PIT,REG,4,PIT,CIN,27,3,1,24
2019,2019_05_LA_SEA,REG,5,SEA,LA,30,29,1,1
2019,2019_05_JAX_CAR,REG,5,CAR,JAX,34,27,1,7
2019,2019_05_ARI_CIN,REG,5,CIN,ARI,23,26,0,-3
2019,2019_05_ATL_HOU,REG,5,HOU,ATL,53,32,1,21
2019,2019_05_TB_NO,REG,5,NO,TB,31,24,1,7
2019,2019_05_MIN_NYG,REG,5,NYG,MIN,10,28,0,-18
2019,2019_05_CHI_OAK,REG,5,OAK,CHI,24,21,1,3
2019,2019_05_NYJ_PHI,REG,5,PHI,NYJ,31,6,1,25
2019,2019_05_BAL_PIT,REG,5,PIT,BAL,23,26,0,-3
2019,2019_05_BUF_TEN,REG,5,TEN,BUF,7,14,0,-7
2019,2019_05_NE_WAS,REG,5,WAS,NE,7,33,0,-26
2019,2019_05_DEN_LAC,REG,5,LAC,DEN,13,20,0,-7
2019,2019_05_GB_DAL,REG,5,DAL,GB,24,34,0,-10
2019,2019_05_IND_KC,REG,5,KC,IND,13,19,0,-6
2019,2019_05_CLE_SF,REG,5,SF,CLE,31,3,1,28
2019,2019_06_NYG_NE,REG,6,NE,NYG,35,14,1,21
2019,2019_06_CAR_TB,REG,6,TB,CAR,26,37,0,-11
2019,2019_06_CIN_BAL,REG,6,BAL,CIN,23,17,1,6
2019,2019_06_SEA_CLE,REG,6,CLE,SEA,28,32,0,-4
2019,2019_06_NO_JAX,REG,6,JAX,NO,6,13,0,-7
2019,2019_06_HOU_KC,REG,6,KC,HOU,24,31,0,-7
2019,2019_06_WAS_MIA,REG,6,MIA,WAS,16,17,0,-1
2019,2019_06_PHI_MIN,REG,6,MIN,PHI,38,20,1,18
2019,2019_06_ATL_ARI,REG,6,ARI,ATL,34,33,1,1
2019,2019_06_SF_LA,REG,6,LA,SF,7,20,0,-13
2019,2019_06_TEN_DEN,REG,6,DEN,TEN,16,0,1,16
2019,2019_06_DAL_NYJ,REG,6,NYJ,DAL,24,22,1,2
2019,2019_06_PIT_LAC,REG,6,LAC,PIT,17,24,0,-7
2019,2019_06_DET_GB,REG,6,GB,DET,23,22,1,1
2019,2019_07_KC_DEN,REG,7,DEN,KC,6,30,0,-24
2019,2019_07_LA_ATL,REG,7,ATL,LA,10,37,0,-27
2019,2019_07_MIA_BUF,REG,7,BUF,MIA,31,21,1,10
2019,2019_07_JAX_CIN,REG,7,CIN,JAX,17,27,0,-10
2019,2019_07_MIN_DET,REG,7,DET,MIN,30,42,0,-12
2019,2019_07_OAK_GB,REG,7,GB,OAK,42,24,1,18
2019,2019_07_HOU_IND,REG,7,IND,HOU,30,23,1,7
2019,2019_07_ARI_NYG,REG,7,NYG,ARI,21,27,0,-6
2019,2019_07_SF_WAS,REG,7,WAS,SF,0,9,0,-9
2019,2019_07_LAC_TEN,REG,7,TEN,LAC,23,20,1,3
2019,2019_07_NO_CHI,REG,7,CHI,NO,25,36,0,-11
2019,2019_07_BAL_SEA,REG,7,SEA,BAL,16,30,0,-14
2019,2019_07_PHI_DAL,REG,7,DAL,PHI,37,10,1,27
2019,2019_07_NE_NYJ,REG,7,NYJ,NE,0,33,0,-33
2019,2019_08_WAS_MIN,REG,8,MIN,WAS,19,9,1,10
2019,2019_08_SEA_ATL,REG,8,ATL,SEA,20,27,0,-7
2019,2019_08_PHI_BUF,REG,8,BUF,PHI,13,31,0,-18
2019,2019_08_LAC_CHI,REG,8,CHI,LAC,16,17,0,-1
2019,2019_08_NYG_DET,REG,8,DET,NYG,31,26,1,5
2019,2019_08_DEN_IND,REG,8,IND,DEN,15,13,1,2
2019,2019_08_NYJ_JAX,REG,8,JAX,NYJ,29,15,1,14
2019,2019_08_CIN_LA,REG,8,LA,CIN,24,10,1,14
2019,2019_08_ARI_NO,REG,8,NO,ARI,31,9,1,22
2019,2019_08_TB_TEN,REG,8,TEN,TB,27,23,1,4
2019,2019_08_CAR_SF,REG,8,SF,CAR,51,13,1,38
2019,2019_08_OAK_HOU,REG,8,HOU,OAK,27,24,1,3
2019,2019_08_CLE_NE,REG,8,NE,CLE,27,13,1,14
2019,2019_08_GB_KC,REG,8,KC,GB,24,31,0,-7
2019,2019_08_MIA_PIT,REG,8,PIT,MIA,27,14,1,13
2019,2019_09_SF_ARI,REG,9,ARI,SF,25,28,0,-3
2019,2019_09_HOU_JAX,REG,9,JAX,HOU,3,26,0,-23
2019,2019_09_WAS_BUF,REG,9,BUF,WAS,24,9,1,15
2019,2019_09_TEN_CAR,REG,9,CAR,TEN,30,20,1,10
2019,2019_09_MIN_KC,REG,9,KC,MIN,26,23,1,3
2019,2019_09_NYJ_MIA,REG,9,MIA,NYJ,26,18,1,8
2019,2019_09_CHI_PHI,REG,9,PHI,CHI,22,14,1,8
2019,2019_09_IND_PIT,REG,9,PIT,IND,26,24,1,2
2019,2019_09_DET_OAK,REG,9,OAK,DET,31,24,1,7
2019,2019_09_TB_SEA,REG,9,SEA,TB,40,34,1,6
2019,2019_09_CLE_DEN,REG,9,DEN,CLE,24,19,1,5
2019,2019_09_GB_LAC,REG,9,LAC,GB,26,11,1,15
2019,2019_09_NE_BAL,REG,9,BAL,NE,37,20,1,17
2019,2019_09_DAL_NYG,REG,9,NYG,DAL,18,37,0,-19
2019,2019_10_LAC_OAK,REG,10,OAK,LAC,26,24,1,2
2019,2019_10_DET_CHI,REG,10,CHI,DET,20,13,1,7
2019,2019_10_BAL_CIN,REG,10,CIN,BAL,13,49,0,-36
2019,2019_10_BUF_CLE,REG,10,CLE,BUF,19,16,1,3
2019,2019_10_ATL_NO,REG,10,NO,ATL,9,26,0,-17
2019,2019_10_NYG_NYJ,REG,10,NYJ,NYG,34,27,1,7
2019,2019_10_ARI_TB,REG,10,TB,ARI,30,27,1,3
2019,2019_10_KC_TEN,REG,10,TEN,KC,35,32,1,3
2019,2019_10_MIA_IND,REG,10,IND,MIA,12,16,0,-4
2019,2019_10_CAR_GB,REG,10,GB,CAR,24,16,1,8
2019,2019_10_LA_PIT,REG,10,PIT,LA,17,12,1,5
2019,2019_10_MIN_DAL,REG,10,DAL,MIN,24,28,0,-4
2019,2019_10_SEA_SF,REG,10,SF,SEA,24,27,0,-3
2019,2019_11_PIT_CLE,REG,11,CLE,PIT,21,7,1,14
2019,2019_11_HOU_BAL,REG,11,BAL,HOU,41,7,1,34
2019,2019_11_ATL_CAR,REG,11,CAR,ATL,3,29,0,-26
2019,2019_11_DAL_DET,REG,11,DET,DAL,27,35,0,-8
2019,2019_11_JAX_IND,REG,11,IND,JAX,33,13,1,20
2019,2019_11_BUF_MIA,REG,11,MIA,BUF,20,37,0,-17
2019,2019_11_DEN_MIN,REG,11,MIN,DEN,27,23,1,4
2019,2019_11_NO_TB,REG,11,TB,NO,17,34,0,-17
2019,2019_11_NYJ_WAS,REG,11,WAS,NYJ,17,34,0,-17
2019,2019_11_ARI_SF,REG,11,SF,ARI,36,26,1,10
2019,2019_11_CIN_OAK,REG,11,OAK,CIN,17,10,1,7
2019,2019_11_NE_PHI,REG,11,PHI,NE,10,17,0,-7
2019,2019_11_CHI_LA,REG,11,LA,CHI,17,7,1,10
2019,2019_11_KC_LAC,REG,11,LAC,KC,17,24,0,-7
2019,2019_12_IND_HOU,REG,12,HOU,IND,20,17,1,3
2019,2019_12_TB_ATL,REG,12,ATL,TB,22,35,0,-13
2019,2019_12_DEN_BUF,REG,12,BUF,DEN,20,3,1,17
2019,2019_12_NYG_CHI,REG,12,CHI,NYG,19,14,1,5
2019,2019_12_PIT_CIN,REG,12,CIN,PIT,10,16,0,-6
2019,2019_12_MIA_CLE,REG,12,CLE,MIA,41,24,1,17
2019,2019_12_CAR_NO,REG,12,NO,CAR,34,31,1,3
2019,2019_12_OAK_NYJ,REG,12,NYJ,OAK,34,3,1,31
2019,2019_12_SEA_PHI,REG,12,PHI,SEA,9,17,0,-8
2019,2019_12_DET_WAS,REG,12,WAS,DET,19,16,1,3
2019,2019_12_JAX_TEN,REG,12,TEN,JAX,42,20,1,22
2019,2019_12_DAL_NE,REG,12,NE,DAL,13,9,1,4
2019,2019_12_GB_SF,REG,12,SF,GB,37,8,1,29
2019,2019_12_BAL_LA,REG,12,LA,BAL,6,45,0,-39
2019,2019_13_CHI_DET,REG,13,DET,CHI,20,24,0,-4
2019,2019_13_BUF_DAL,REG,13,DAL,BUF,15,26,0,-11
2019,2019_13_NO_ATL,REG,13,ATL,NO,18,26,0,-8
2019,2019_13_SF_BAL,REG,13,BAL,SF,20,17,1,3
2019,2019_13_WAS_CAR,REG,13,CAR,WAS,21,29,0,-8
2019,2019_13_NYJ_CIN,REG,13,CIN,NYJ,22,6,1,16
2019,2019_13_TEN_IND,REG,13,IND,TEN,17,31,0,-14
2019,2019_13_TB_JAX,REG,13,JAX,TB,11,28,0,-17
2019,2019_13_PHI_MIA,REG,13,MIA,PHI,37,31,1,6
2019,2019_13_GB_NYG,REG,13,NYG,GB,13,31,0,-18
2019,2019_13_CLE_PIT,REG,13,PIT,CLE,20,13,1,7
2019,2019_13_LA_ARI,REG,13,ARI,LA,7,34,0,-27
2019,2019_13_LAC_DEN,REG,13,DEN,LAC,23,20,1,3
2019,2019_13_OAK_KC,REG,13,KC,OAK,40,9,1,31
2019,2019_13_NE_HOU,REG,13,HOU,NE,28,22,1,6
2019,2019_13_MIN_SEA,REG,13,SEA,MIN,37,30,1,7
2019,2019_14_DAL_CHI,REG,14,CHI,DAL,31,24,1,7
2019,2019_14_CAR_ATL,REG,14,ATL,CAR,40,20,1,20
2019,2019_14_BAL_BUF,REG,14,BUF,BAL,17,24,0,-7
2019,2019_14_CIN_CLE,REG,14,CLE,CIN,27,19,1,8
2019,2019_14_WAS_GB,REG,14,GB,WAS,20,15,1,5
2019,2019_14_DEN_HOU,REG,14,HOU,DEN,24,38,0,-14
2019,2019_14_DET_MIN,REG,14,MIN,DET,20,7,1,13
2019,2019_14_SF_NO,REG,14,NO,SF,46,48,0,-2
2019,2019_14_MIA_NYJ,REG,14,NYJ,MIA,22,21,1,1
2019,2019_14_IND_TB,REG,14,TB,IND,38,35,1,3
2019,2019_14_LAC_JAX,REG,14,JAX,LAC,10,45,0,-35
2019,2019_14_PIT_ARI,REG,14,ARI,PIT,17,23,0,-6
2019,2019_14_KC_NE,REG,14,NE,KC,16,23,0,-7
2019,2019_14_TEN_OAK,REG,14,OAK,TEN,21,42,0,-21
2019,2019_14_SEA_LA,REG,14,LA,SEA,28,12,1,16
2019,2019_14_NYG_PHI,REG,14,PHI,NYG,23,17,1,6
2019,2019_15_NYJ_BAL,REG,15,BAL,NYJ,42,21,1,21
2019,2019_15_SEA_CAR,REG,15,CAR,SEA,24,30,0,-6
2019,2019_15_NE_CIN,REG,15,CIN,NE,13,34,0,-21
2019,2019_15_TB_DET,REG,15,DET,TB,17,38,0,-21
2019,2019_15_CHI_GB,REG,15,GB,CHI,21,13,1,8
2019,2019_15_DEN_KC,REG,15,KC,DEN,23,3,1,20
2019,2019_15_MIA_NYG,REG,15,NYG,MIA,36,20,1,16
2019,2019_15_HOU_TEN,REG,15,TEN,HOU,21,24,0,-3
2019,2019_15_PHI_WAS,REG,15,WAS,PHI,27,37,0,-10
2019,2019_15_CLE_ARI,REG,15,ARI,CLE,38,24,1,14
2019,2019_15_MIN_LAC,REG,15,LAC,MIN,10,39,0,-29
2019,2019_15_JAX_OAK,REG,15,OAK,JAX,16,20,0,-4
2019,2019_15_LA_DAL,REG,15,DAL,LA,44,21,1,23
2019,2019_15_ATL_SF,REG,15,SF,ATL,22,29,0,-7
2019,2019_15_BUF_PIT,REG,15,PIT,BUF,10,17,0,-7
2019,2019_15_IND_NO,REG,15,NO,IND,34,7,1,27
2019,2019_16_HOU_TB,REG,16,TB,HOU,20,23,0,-3
2019,2019_16_BUF_NE,REG,16,NE,BUF,24,17,1,7
2019,2019_16_LA_SF,REG,16,SF,LA,34,31,1,3
2019,2019_16_JAX_ATL,REG,16,ATL,JAX,24,12,1,12
2019,2019_16_BAL_CLE,REG,16,CLE,BAL,15,31,0,-16
2019,2019_16_CAR_IND,REG,16,IND,CAR,38,6,1,32
2019,2019_16_CIN_MIA,REG,16,MIA,CIN,38,35,1,3
2019,2019_16_PIT_NYJ,REG,16,NYJ,PIT,16,10,1,6
2019,2019_16_NO_TEN,REG,16,TEN,NO,28,38,0,-10
2019,2019_16_NYG_WAS,REG,16,WAS,NYG,35,41,0,-6
2019,2019_16_DET_DEN,REG,16,DEN,DET,27,17,1,10
2019,2019_16_OAK_LAC,REG,16,LAC,OAK,17,24,0,-7
2019,2019_16_DAL_PHI,REG,16,PHI,DAL,17,9,1,8
2019,2019_16_ARI_SEA,REG,16,SEA,ARI,13,27,0,-14
2019,2019_16_KC_CHI,REG,16,CHI,KC,3,26,0,-23
2019,2019_16_GB_MIN,REG,16,MIN,GB,10,23,0,-13
2019,2019_17_NYJ_BUF,REG,17,BUF,NYJ,6,13,0,-7
2019,2019_17_NO_CAR,REG,17,CAR,NO,10,42,0,-32
2019,2019_17_CLE_CIN,REG,17,CIN,CLE,33,23,1,10
2019,2019_17_GB_DET,REG,17,DET,GB,20,23,0,-3
2019,2019_17_LAC_KC,REG,17,KC,LAC,31,21,1,10
2019,2019_17_CHI_MIN,REG,17,MIN,CHI,19,21,0,-2
2019,2019_17_MIA_NE,REG,17,NE,MIA,24,27,0,-3
2019,2019_17_ATL_TB,REG,17,TB,ATL,22,28,0,-6
2019,2019_17_PIT_BAL,REG,17,BAL,PIT,28,10,1,18
2019,2019_17_WAS_DAL,REG,17,DAL,WAS,47,16,1,31
2019,2019_17_OAK_DEN,REG,17,DEN,OAK,16,15,1,1
2019,2019_17_TEN_HOU,REG,17,HOU,TEN,14,35,0,-21
2019,2019_17_IND_JAX,REG,17,JAX,IND,38,20,1,18
2019,2019_17_ARI_LA,REG,17,LA,ARI,31,24,1,7
2019,2019_17_PHI_NYG,REG,17,NYG,PHI,17,34,0,-17
2019,2019_17_SF_SEA,REG,17,SEA,SF,21,26,0,-5
2019,2019_18_BUF_HOU,WC,18,HOU,BUF,22,19,1,3
2019,2019_18_TEN_NE,WC,18,NE,TEN,13,20,0,-7
2019,2019_18_MIN_NO,WC,18,NO,MIN,20,26,0,-6
2019,2019_18_SEA_PHI,WC,18,PHI,SEA,9,17,0,-8
2019,2019_19_MIN_SF,DIV,19,SF,MIN,27,10,1,17
2019,2019_19_TEN_BAL,DIV,19,BAL,TEN,12,28,0,-16
2019,2019_19_HOU_KC,DIV,19,KC,HOU,51,31,1,20
2019,2019_19_SEA_GB,DIV,19,GB,SEA,28,23,1,5
2019,2019_20_TEN_KC,CON,20,KC,TEN,35,24,1,11
2019,2019_20_GB_SF,CON,20,SF,GB,37,20,1,17
2019,2019_21_SF_KC,SB,21,KC,SF,31,20,1,11
2020,2020_01_HOU_KC,REG,1,KC,HOU,34,20,1,14
2020,2020_01_SEA_ATL,REG,1,ATL,SEA,25,38,0,-13
2020,2020_01_CLE_BAL,REG,1,BAL,CLE,38,6,1,32
2020,2020_01_NYJ_BUF,REG,1,BUF,NYJ,27,17,1,10
2020,2020_01_LV_CAR,REG,1,CAR,LV,30,34,0,-4
2020,2020_01_CHI_DET,REG,1,DET,CHI,23,27,0,-4
2020,2020_01_IND_JAX,REG,1,JAX,IND,27,20,1,7
2020,2020_01_GB_MIN,REG,1,MIN,GB,34,43,0,-9
2020,2020_01_MIA_NE,REG,1,NE,MIA,21,11,1,10
2020,2020_01_PHI_WAS,REG,1,WAS,PHI,27,17,1,10
2020,2020_01_LAC_CIN,REG,1,CIN,LAC,13,16,0,-3
2020,2020_01_TB_NO,REG,1,NO,TB,34,23,1,11
2020,2020_01_ARI_SF,REG,1,SF,ARI,20,24,0,-4
2020,2020_01_DAL_LA,REG,1,LA,DAL,20,17,1,3
2020,2020_01_PIT_NYG,REG,1,NYG,PIT,16,26,0,-10
2020,2020_01_TEN_DEN,REG,1,DEN,TEN,14,16,0,-2
2020,2020_02_CIN_CLE,REG,2,CLE,CIN,35,30,1,5
2020,2020_02_NYG_CHI,REG,2,CHI,NYG,17,13,1,4
2020,2020_02_ATL_DAL,REG,2,DAL,ATL,40,39,1,1
2020,2020_02_DET_GB,REG,2,GB,DET,42,21,1,21
2020,2020_02_MIN_IND,REG,2,IND,MIN,28,11,1,17
2020,2020_02_BUF_MIA,REG,2,MIA,BUF,28,31,0,-3
2020,2020_02_SF_NYJ,REG,2,NYJ,SF,13,31,0,-18
2020,2020_02_LA_PHI,REG,2,PHI,LA,19,37,0,-18
2020,2020_02_DEN_PIT,REG,2,PIT,DEN,26,21,1,5
2020,2020_02_CAR_TB,REG,2,TB,CAR,31,17,1,14
2020,2020_02_JAX_TEN,REG,2,TEN,JAX,33,30,1,3
2020,2020_02_WAS_ARI,REG,2,ARI,WAS,30,15,1,15
2020,2020_02_BAL_HOU,REG,2,HOU,BAL,16,33,0,-17
2020,2020_02_KC_LAC,REG,2,LAC,KC,20,23,0,-3
2020,2020_02_NE_SEA,REG,2,SEA,NE,35,30,1,5
2020,2020_02_NO_LV,REG,2,LV,NO,34,24,1,10
2020,2020_03_MIA_JAX,REG,3,JAX,MIA,13,31,0,-18
2020,2020_03_CHI_ATL,REG,3,ATL,CHI,26,30,0,-4
2020,2020_03_LA_BUF,REG,3,BUF,LA,35,32,1,3
2020,2020_03_WAS_CLE,REG,3,CLE,WAS,34,20,1,14
2020,2020_03_TEN_MIN,REG,3,MIN,TEN,30,31,0,-1
2020,2020_03_LV_NE,REG,3,NE,LV,36,20,1,16
2020,2020_03_SF_NYG,REG,3,NYG,SF,9,36,0,-27
2020,2020_03_CIN_PHI,REG,3,PHI,CIN,23,23,0.5,0
2020,2020_03_HOU_PIT,REG,3,PIT,HOU,28,21,1,7
2020,2020_03_NYJ_IND,REG,3,IND,NYJ,36,7,1,29
2020,2020_03_CAR_LAC,REG,3,LAC,CAR,16,21,0,-5
2020,2020_03_DET_ARI,REG,3,ARI,DET,23,26,0,-3
2020,2020_03_TB_DEN,REG,3,DEN,TB,10,28,0,-18
2020,2020_03_DAL_SEA,REG,3,SEA,DAL,38,31,1,7
2020,2020_03_GB_NO,REG,3,NO,GB,30,37,0,-7
2020,2020_03_KC_BAL,REG,3,BAL,KC,20,34,0,-14
2020,2020_04_DEN_NYJ,REG,4,NYJ,DEN,28,37,0,-9
2020,2020_04_ARI_CAR,REG,4,CAR,ARI,31,21,1,10
2020,2020_04_JAX_CIN,REG,4,CIN,JAX,33,25,1,8
2020,2020_04_CLE_DAL,REG,4,DAL,CLE,38,49,0,-11
2020,2020_04_NO_DET,REG,4,DET,NO,29,35,0,-6
2020,2020_04_MIN_HOU,REG,4,HOU,MIN,23,31,0,-8
2020,2020_04_SEA_MIA,REG,4,MIA,SEA,23,31,0,-8
2020,2020_04_LAC_TB,REG,4,TB,LAC,38,31,1,7
2020,2020_04_BAL_WAS,REG,4,WAS,BAL,17,31,0,-14
2020,2020_04_NYG_LA,REG,4,LA,NYG,17,9,1,8
2020,2020_04_IND_CHI,REG,4,CHI,IND,11,19,0,-8
2020,2020_04_BUF_LV,REG,4,LV,BUF,23,30,0,-7
2020,2020_04_PHI_SF,REG,4,SF,PHI,20,25,0,-5
2020,2020_04_NE_KC,REG,4,KC,NE,26,10,1,16
2020,2020_04_ATL_GB,REG,4,GB,ATL,30,16,1,14
2020,2020_05_TB_CHI,REG,5,CHI,TB,20,19,1,1
2020,2020_05_CAR_ATL,REG,5,ATL,CAR,16,23,0,-7
2020,2020_05_CIN_BAL,REG,5,BAL,CIN,27,3,1,24
2020,2020_05_JAX_HOU,REG,5,HOU,JAX,30,14,1,16
2020,2020_05_LV_KC,REG,5,KC,LV,32,40,0,-8
2020,2020_05_ARI_NYJ,REG,5,NYJ,ARI,10,30,0,-20
2020,2020_05_PHI_PIT,REG,5,PIT,PHI,38,29,1,9
2020,2020_05_LA_WAS,REG,5,WAS,LA,10,30,0,-20
2020,2020_05_MIA_SF,REG,5,SF,MIA,17,43,0,-26
2020,2020_05_IND_CLE,REG,5,CLE,IND,32,23,1,9
2020,2020_05_NYG_DAL,REG,5,DAL,NYG,37,34,1,3
2020,2020_05_MIN_SEA,REG,5,SEA,MIN,27,26,1,1
2020,2020_05_LAC_NO,REG,5,NO,LAC,30,27,1,3
2020,2020_05_BUF_TEN,REG,5,TEN,BUF,42,16,1,26
2020,2020_06_CHI_CAR,REG,6,CAR,CHI,16,23,0,-7
2020,2020_06_CIN_IND,REG,6,IND,CIN,31,27,1,4
2020,2020_06_DET_JAX,REG,6,JAX,DET,16,34,0,-18
2020,2020_06_ATL_MIN,REG,6,MIN,ATL,23,40,0,-17
2020,2020_06_DEN_NE,REG,6,NE,DEN,12,18,0,-6
2020,2020_06_WAS_NYG,REG,6,NYG,WAS,20,19,1,1
2020,2020_06_BAL_PHI,REG,6,PHI,BAL,28,30,0,-2
2020,2020_06_CLE_PIT,REG,6,PIT,CLE,38,7,1,31
2020,2020_06_HOU_TEN,REG,6,TEN,HOU,42,36,1,6
2020,2020_06_NYJ_MIA,REG,6,MIA,NYJ,24,0,1,24
2020,2020_06_GB_TB,REG,6,TB,GB,38,10,1,28
2020,2020_06_LA_SF,REG,6,SF,LA,24,16,1,8
2020,2020_06_KC_BUF,REG,6,BUF,KC,17,26,0,-9
2020,2020_06_ARI_DAL,REG,6,DAL,ARI,10,38,0,-28
2020,2020_07_NYG_PHI,REG,7,PHI,NYG,22,21,1,1
2020,2020_07_DET_ATL,REG,7,ATL,DET,22,23,0,-1
2020,2020_07_CLE_CIN,REG,7,CIN,CLE,34,37,0,-3
2020,2020_07_GB_HOU,REG,7,HOU,GB,20,35,0,-15
2020,2020_07_CAR_NO,REG,7,NO,CAR,27,24,1,3
2020,2020_07_BUF_NYJ,REG,7,NYJ,BUF,10,18,0,-8
2020,2020_07_PIT_TEN,REG,7,TEN,PIT,24,27,0,-3
2020,2020_07_DAL_WAS,REG,7,WAS,DAL,25,3,1,22
2020,2020_07_TB_LV,REG,7,LV,TB,20,45,0,-25
2020,2020_07_KC_DEN,REG,7,DEN,KC,16,43,0,-27
2020,2020_07_JAX_LAC,REG,7,LAC,JAX,39,29,1,10
2020,2020_07_SF_NE,REG,7,NE,SF,6,33,0,-27
2020,2020_07_SEA_ARI,REG,7,ARI,SEA,37,34,1,3
2020,2020_07_CHI_LA,REG,7,LA,CHI,24,10,1,14
2020,2020_08_ATL_CAR,REG,8,CAR,ATL,17,25,0,-8
2020,2020_08_PIT_BAL,REG,8,BAL,PIT,24,28,0,-4
2020,2020_08_NE_BUF,REG,8,BUF,NE,24,21,1,3
2020,2020_08_TEN_CIN,REG,8,CIN,TEN,31,20,1,11
2020,2020_08_LV_CLE,REG,8,CLE,LV,6,16,0,-10
2020,2020_08_IND_DET,REG,8,DET,IND,21,41,0,-20
2020,2020_08_MIN_GB,REG,8,GB,MIN,22,28,0,-6
2020,2020_08_NYJ_KC,REG,8,KC,NYJ,35,9,1,26
2020,2020_08_LA_MIA,REG,8,MIA,LA,28,17,1,11
2020,2020_08_LAC_DEN,REG,8,DEN,LAC,31,30,1,1
2020,2020_08_NO_CHI,REG,8,CHI,NO,23,26,0,-3
2020,2020_08_SF_SEA,REG,8,SEA,SF,37,27,1,10
2020,2020_08_DAL_PHI,REG,8,PHI,DAL,23,9,1,14
2020,2020_08_TB_NYG,REG,8,NYG,TB,23,25,0,-2
2020,2020_09_GB_SF,REG,9,SF,GB,17,34,0,-17
2020,2020_09_DEN_ATL,REG,9,ATL,DEN,34,27,1,7
2020,2020_09_SEA_BUF,REG,9,BUF,SEA,44,34,1,10
2020,2020_09_BAL_IND,REG,9,IND,BAL,10,24,0,-14
2020,2020_09_HOU_JAX,REG,9,JAX,HOU,25,27,0,-2
2020,2020_09_CAR_KC,REG,9,KC,CAR,33,31,1,2
2020,2020_09_DET_MIN,REG,9,MIN,DET,34,20,1,14
2020,2020_09_CHI_TEN,REG,9,TEN,CHI,24,17,1,7
2020,2020_09_NYG_WAS,REG,9,WAS,NYG,20,23,0,-3
2020,2020_09_LV_LAC,REG,9,LAC,LV,26,31,0,-5
2020,2020_09_MIA_ARI,REG,9,ARI,MIA,31,34,0,-3
2020,2020_09_PIT_DAL,REG,9,DAL,PIT,19,24,0,-5
2020,2020_09_NO_TB,REG,9,TB,NO,3,38,0,-35
2020,2020_09_NE_NYJ,REG,9,NYJ,NE,27,30,0,-3
2020,2020_10_IND_TEN,REG,10,TEN,IND,17,34,0,-17
2020,2020_10_TB_CAR,REG,10,CAR,TB,23,46,0,-23
2020,2020_10_HOU_CLE,REG,10,CLE,HOU,10,7,1,3
2020,2020_10_WAS_DET,REG,10,DET,WAS,30,27,1,3
2020,2020_10_JAX_GB,REG,10,GB,JAX,24,20,1,4
2020,2020_10_PHI_NYG,REG,10,NYG,PHI,27,17,1,10
2020,2020_10_BUF_ARI,REG,10,ARI,BUF,32,30,1,2
2020,2020_10_DEN_LV,REG,10,LV,DEN,37,12,1,25
2020,2020_10_LAC_MIA,REG,10,MIA,LAC,29,21,1,8
2020,2020_10_SEA_LA,REG,10,LA,SEA,23,16,1,7
2020,2020_10_SF_NO,REG,10,NO,SF,27,13,1,14
2020,2020_10_CIN_PIT,REG,10,PIT,CIN,36,10,1,26
2020,2020_10_BAL_NE,REG,10,NE,BAL,23,17,1,6
2020,2020_10_MIN_CHI,REG,10,CHI,MIN,13,19,0,-6
2020,2020_11_ARI_SEA,REG,11,SEA,ARI,28,21,1,7
2020,2020_11_TEN_BAL,REG,11,BAL,TEN,24,30,0,-6
2020,2020_11_DET_CAR,REG,11,CAR,DET,20,0,1,20
2020,2020_11_PHI_CLE,REG,11,CLE,PHI,22,17,1,5
2020,2020_11_NE_HOU,REG,11,HOU,NE,27,20,1,7
2020,2020_11_PIT_JAX,REG,11,JAX,PIT,3,27,0,-24
2020,2020_11_ATL_NO,REG,11,NO,ATL,24,9,1,15
2020,2020_11_CIN_WAS,REG,11,WAS,CIN,20,9,1,11
2020,2020_11_MIA_DEN,REG,11,DEN,MIA,20,13,1,7
2020,2020_11_NYJ_LAC,REG,11,LAC,NYJ,34,28,1,6
2020,2020_11_GB_IND,REG,11,IND,GB,34,31,1,3
2020,2020_11_DAL_MIN,REG,11,MIN,DAL,28,31,0,-3
2020,2020_11_KC_LV,REG,11,LV,KC,31,35,0,-4
2020,2020_11_LA_TB,REG,11,TB,LA,24,27,0,-3
2020,2020_12_HOU_DET,REG,12,DET,HOU,25,41,0,-16
2020,2020_12_WAS_DAL,REG,12,DAL,WAS,16,41,0,-25
2020,2020_12_LV_ATL,REG,12,ATL,LV,43,6,1,37
2020,2020_12_LAC_BUF,REG,12,BUF,LAC,27,17,1,10
2020,2020_12_NYG_CIN,REG,12,CIN,NYG,17,19,0,-2
2020,2020_12_TEN_IND,REG,12,IND,TEN,26,45,0,-19
2020,2020_12_CLE_JAX,REG,12,JAX,CLE,25,27,0,-2
2020,2020_12_CAR_MIN,REG,12,MIN,CAR,28,27,1,1
2020,2020_12_ARI_NE,REG,12,NE,ARI,20,17,1,3
2020,2020_12_MIA_NYJ,REG,12,NYJ,MIA,3,20,0,-17
2020,2020_12_NO_DEN,REG,12,DEN,NO,3,31,0,-28
2020,2020_12_SF_LA,REG,12,LA,SF,20,23,0,-3
2020,2020_12_KC_TB,REG,12,TB,KC,24,27,0,-3
2020,2020_12_CHI_GB,REG,12,GB,CHI,41,25,1,16
2020,2020_12_SEA_PHI,REG,12,PHI,SEA,17,23,0,-6
2020,2020_12_BAL_PIT,REG,12,PIT,BAL,19,14,1,5
2020,2020_13_NO_ATL,REG,13,ATL,NO,16,21,0,-5
2020,2020_13_DET_CHI,REG,13,CHI,DET,30,34,0,-4
2020,2020_13_IND_HOU,REG,13,HOU,IND,20,26,0,-6
2020,2020_13_CIN_MIA,REG,13,MIA,CIN,19,7,1,12
2020,2020_13_JAX_MIN,REG,13,MIN,JAX,27,24,1,3
2020,2020_13_LV_NYJ,REG,13,NYJ,LV,28,31,0,-3
2020,2020_13_CLE_TEN,REG,13,TEN,CLE,35,41,0,-6
2020,2020_13_LA_ARI,REG,13,ARI,LA,28,38,0,-10
2020,2020_13_NYG_SEA,REG,13,SEA,NYG,12,17,0,-5
2020,2020_13_PHI_GB,REG,13,GB,PHI,30,16,1,14
2020,2020_13_NE_LAC,REG,13,LAC,NE,0,45,0,-45
2020,2020_13_DEN_KC,REG,13,KC,DEN,22,16,1,6
2020,2020_13_WAS_PIT,REG,13,PIT,WAS,17,23,0,-6
2020,2020_13_BUF_SF,REG,13,SF,BUF,24,34,0,-10
2020,2020_13_DAL_BAL,REG,13,BAL,DAL,34,17,1,17
2020,2020_14_NE_LA,REG,14,LA,NE,24,3,1,21
2020,2020_14_DEN_CAR,REG,14,CAR,DEN,27,32,0,-5
2020,2020_14_HOU_CHI,REG,14,CHI,HOU,36,7,1,29
2020,2020_14_DAL_CIN,REG,14,CIN,DAL,7,30,0,-23
2020,2020_14_TEN_JAX,REG,14,JAX,TEN,10,31,0,-21
2020,2020_14_KC_MIA,REG,14,MIA,KC,27,33,0,-6
2020,2020_14_ARI_NYG,REG,14,NYG,ARI,7,26,0,-19
2020,2020_14_MIN_TB,REG,14,TB,MIN,26,14,1,12
2020,2020_14_IND_LV,REG,14,LV,IND,27,44,0,-17
2020,2020_14_NYJ_SEA,REG,14,SEA,NYJ,40,3,1,37
2020,2020_14_GB_DET,REG,14,DET,GB,24,31,0,-7
2020,2020_14_ATL_LAC,REG,14,LAC,ATL,20,17,1,3
2020,2020_14_NO_PHI,REG,14,PHI,NO,24,21,1,3
2020,2020_14_WAS_SF,REG,14,SF,WAS,15,23,0,-8
2020,2020_14_PIT_BUF,REG,14,BUF,PIT,26,15,1,11
2020,2020_14_BAL_CLE,REG,14,CLE,BAL,42,47,0,-5
2020,2020_15_LAC_LV,REG,15,LV,LAC,27,30,0,-3
2020,2020_15_BUF_DEN,REG,15,DEN,BUF,19,48,0,-29
2020,2020_15_CAR_GB,REG,15,GB,CAR,24,16,1,8
2020,2020_15_TB_ATL,REG,15,ATL,TB,27,31,0,-4
2020,2020_15_JAX_BAL,REG,15,BAL,JAX,40,14,1,26
2020,2020_15_SF_DAL,REG,15,DAL,SF,41,33,1,8
2020,2020_15_HOU_IND,REG,15,IND,HOU,27,20,1,7
2020,2020_15_NE_MIA,REG,15,MIA,NE,22,12,1,10
2020,2020_15_CHI_MIN,REG,15,MIN,CHI,27,33,0,-6
2020,2020_15_DET_TEN,REG,15,TEN,DET,46,25,1,21
2020,2020_15_SEA_WAS,REG,15,WAS,SEA,15,20,0,-5
2020,2020_15_PHI_ARI,REG,15,ARI,PHI,33,26,1,7
2020,2020_15_NYJ_LA,REG,15,LA,NYJ,20,23,0,-3
2020,2020_15_KC_NO,REG,15,NO,KC,29,32,0,-3
2020,2020_15_CLE_NYG,REG,15,NYG,CLE,6,20,0,-14
2020,2020_15_PIT_CIN,REG,15,CIN,PIT,27,17,1,10
2020,2020_16_MIN_NO,REG,16,NO,MIN,52,33,1,19
2020,2020_16_TB_DET,REG,16,DET,TB,7,47,0,-40
2020,2020_16_SF_ARI,REG,16,ARI,SF,12,20,0,-8
2020,2020_16_MIA_LV,REG,16,LV,MIA,25,26,0,-1
2020,2020_16_NYG_BAL,REG,16,BAL,NYG,27,13,1,14
2020,2020_16_CIN_HOU,REG,16,HOU,CIN,31,37,0,-6
2020,2020_16_CHI_JAX,REG,16,JAX,CHI,17,41,0,-24
2020,2020_16_ATL_KC,REG,16,KC,ATL,17,14,1,3
2020,2020_16_CLE_NYJ,REG,16,NYJ,CLE,23,16,1,7
2020,2020_16_IND_PIT,REG,16,PIT,IND,28,24,1,4
2020,2020_16_DEN_LAC,REG,16,LAC,DEN,19,16,1,3
2020,2020_16_CAR_WAS,REG,16,WAS,CAR,13,20,0,-7
2020,2020_16_PHI_DAL,REG,16,DAL,PHI,37,17,1,20
2020,2020_16_LA_SEA,REG,16,SEA,LA,20,9,1,11
2020,2020_16_TEN_GB,REG,16,GB,TEN,40,14,1,26
2020,2020_16_BUF_NE,REG,16,NE,BUF,9,38,0,-29
2020,2020_17_MIA_BUF,REG,17,BUF,MIA,56,26,1,30
2020,2020_17_BAL_CIN,REG,17,CIN,BAL,3,38,0,-35
2020,2020_17_PIT_CLE,REG,17,CLE,PIT,24,22,1,2
2020,2020_17_MIN_DET,REG,17,DET,MIN,35,37,0,-2
2020,2020_17_NYJ_NE,REG,17,NE,NYJ,28,14,1,14
2020,2020_17_DAL_NYG,REG,17,NYG,DAL,23,19,1,4
2020,2020_17_ATL_TB,REG,17,TB,ATL,44,27,1,17
2020,2020_17_NO_CAR,REG,17,CAR,NO,7,33,0,-26
2020,2020_17_GB_CHI,REG,17,CHI,GB,16,35,0,-19
2020,2020_17_LV_DEN,REG,17,DEN,LV,31,32,0,-1
2020,2020_17_TEN_HOU,REG,17,HOU,TEN,38,41,0,-3
2020,2020_17_JAX_IND,REG,17,IND,JAX,28,14,1,14
2020,2020_17_LAC_KC,REG,17,KC,LAC,21,38,0,-17
2020,2020_17_ARI_LA,REG,17,LA,ARI,18,7,1,11
2020,2020_17_SEA_SF,REG,17,SF,SEA,23,26,0,-3
2020,2020_17_WAS_PHI,REG,17,PHI,WAS,14,20,0,-6
2020,2020_18_IND_BUF,WC,18,BUF,IND,27,24,1,3
2020,2020_18_LA_SEA,WC,18,SEA,LA,20,30,0,-10
2020,2020_18_TB_WAS,WC,18,WAS,TB,23,31,0,-8
2020,2020_18_BAL_TEN,WC,18,TEN,BAL,13,20,0,-7
2020,2020_18_CHI_NO,WC,18,NO,CHI,21,9,1,12
2020,2020_18_CLE_PIT,WC,18,PIT,CLE,37,48,0,-11
2020,2020_19_LA_GB,DIV,19,GB,LA,32,18,1,14
2020,2020_19_BAL_BUF,DIV,19,BUF,BAL,17,3,1,14
2020,2020_19_CLE_KC,DIV,19,KC,CLE,22,17,1,5
2020,2020_19_TB_NO,DIV,19,NO,TB,20,30,0,-10
2020,2020_20_TB_GB,CON,20,GB,TB,26,31,0,-5
2020,2020_20_BUF_KC,CON,20,KC,BUF,38,24,1,14
2020,2020_21_KC_TB,SB,21,TB,KC,31,9,1,22
2021,2021_01_DAL_TB,REG,1,TB,DAL,31,29,1,2
2021,2021_01_PHI_ATL,REG,1,ATL,PHI,6,32,0,-26
2021,2021_01_PIT_BUF,REG,1,BUF,PIT,16,23,0,-7
2021,2021_01_NYJ_CAR,REG,1,CAR,NYJ,19,14,1,5
2021,2021_01_MIN_CIN,REG,1,CIN,MIN,27,24,1,3
2021,2021_01_SF_DET,REG,1,DET,SF,33,41,0,-8
2021,2021_01_JAX_HOU,REG,1,HOU,JAX,37,21,1,16
2021,2021_01_SEA_IND,REG,1,IND,SEA,16,28,0,-12
2021,2021_01_ARI_TEN,REG,1,TEN,ARI,13,38,0,-25
2021,2021_01_LAC_WAS,REG,1,WAS,LAC,16,20,0,-4
2021,2021_01_CLE_KC,REG,1,KC,CLE,33,29,1,4
2021,2021_01_MIA_NE,REG,1,NE,MIA,16,17,0,-1
2021,2021_01_GB_NO,REG,1,NO,GB,38,3,1,35
2021,2021_01_DEN_NYG,REG,1,NYG,DEN,13,27,0,-14
2021,2021_01_CHI_LA,REG,1,LA,CHI,34,14,1,20
2021,2021_01_BAL_LV,REG,1,LV,BAL,33,27,1,6
2021,2021_02_NYG_WAS,REG,2,WAS,NYG,30,29,1,1
2021,2021_02_NO_CAR,REG,2,CAR,NO,26,7,1,19
2021,2021_02_CIN_CHI,REG,2,CHI,CIN,20,17,1,3
2021,2021_02_HOU_CLE,REG,2,CLE,HOU,31,21,1,10
2021,2021_02_LA_IND,REG,2,IND,LA,24,27,0,-3
2021,2021_02_DEN_JAX,REG,2,JAX,DEN,13,23,0,-10
2021,2021_02_BUF_MIA,REG,2,MIA,BUF,0,35,0,-35
2021,2021_02_NE_NYJ,REG,2,NYJ,NE,6,25,0,-19
2021,2021_02_SF_PHI,REG,2,PHI,SF,11,17,0,-6
2021,2021_02_LV_PIT,REG,2,PIT,LV,17,26,0,-9
2021,2021_02_MIN_ARI,REG,2,ARI,MIN,34,33,1,1
2021,2021_02_ATL_TB,REG,2,TB,ATL,48,25,1,23
2021,2021_02_DAL_LAC,REG,2,LAC,DAL,17,20,0,-3
2021,2021_02_TEN_SEA,REG,2,SEA,TEN,30,33,0,-3
2021,2021_02_KC_BAL,REG,2,BAL,KC,36,35,1,1
2021,2021_02_DET_GB,REG,2,GB,DET,35,17,1,18
2021,2021_03_CAR_HOU,REG,3,HOU,CAR,9,24,0,-15
2021,2021_03_WAS_BUF,REG,3,BUF,WAS,43,21,1,22
2021,2021_03_CHI_CLE,REG,3,CLE,CHI,26,6,1,20
2021,2021_03_BAL_DET,REG,3,DET,BAL,17,19,0,-2
2021,2021_03_ARI_JAX,REG,3,JAX,ARI,19,31,0,-12
2021,2021_03_LAC_KC,REG,3,KC,LAC,24,30,0,-6
2021,2021_03_NO_NE,REG,3,NE,NO,13,28,0,-15
2021,2021_03_ATL_NYG,REG,3,NYG,ATL,14,17,0,-3
2021,2021_03_CIN_PIT,REG,3,PIT,CIN,10,24,0,-14
2021,2021_03_IND_TEN,REG,3,TEN,IND,25,16,1,9
2021,2021_03_NYJ_DEN,REG,3,DEN,NYJ,26,0,1,26
2021,2021_03_MIA_LV,REG,3,LV,MIA,31,28,1,3
2021,2021_03_TB_LA,REG,3,LA,TB,34,24,1,10
2021,2021_03_SEA_MIN,REG,3,MIN,SEA,30,17,1,13
2021,2021_03_GB_SF,REG,3,SF,GB,28,30,0,-2
2021,2021_03_PHI_DAL,REG,3,DAL,PHI,41,21,1,20
2021,2021_04_JAX_CIN,REG,4,CIN,JAX,24,21,1,3
2021,2021_04_WAS_ATL,REG,4,ATL,WAS,30,34,0,-4
2021,2021_04_HOU_BUF,REG,4,BUF,HOU,40,0,1,40
2021,2021_04_DET_CHI,REG,4,CHI,DET,24,14,1,10
2021,2021_04_CAR_DAL,REG,4,DAL,CAR,36,28,1,8
2021,2021_04_IND_MIA,REG,4,MIA,IND,17,27,0,-10
2021,2021_04_CLE_MIN,REG,4,MIN,CLE,7,14,0,-7
2021,2021_04_NYG_NO,REG,4,NO,NYG,21,27,0,-6
2021,2021_04_TEN_NYJ,REG,4,NYJ,TEN,27,24,1,3
2021,2021_04_KC_PHI,REG,4,PHI,KC,30,42,0,-12
2021,2021_04_ARI_LA,REG,4,LA,ARI,20,37,0,-17
2021,2021_04_SEA_SF,REG,4,SF,SEA,21,28,0,-7
2021,2021_04_BAL_DEN,REG,4,DEN,BAL,7,23,0,-16
2021,2021_04_PIT_GB,REG,4,GB,PIT,27,17,1,10
2021,2021_04_TB_NE,REG,4,NE,TB,17,19,0,-2
2021,2021_04_LV_LAC,REG,4,LAC,LV,28,14,1,14
2021,2021_05_LA_SEA,REG,5,SEA,LA,17,26,0,-9
2021,2021_05_NYJ_ATL,REG,5,ATL,NYJ,27,20,1,7
2021,2021_05_PHI_CAR,REG,5,CAR,PHI,18,21,0,-3
2021,2021_05_GB_CIN,REG,5,CIN,GB,22,25,0,-3
2021,2021_05_NE_HOU,REG,5,HOU,NE,22,25,0,-3
2021,2021_05_TEN_JAX,REG,5,JAX,TEN,19,37,0,-18
2021,2021_05_DET_MIN,REG,5,MIN,DET,19,17,1,2
2021,2021_05_DEN_PIT,REG,5,PIT,DEN,27,19,1,8
2021,2021_05_MIA_TB,REG,5,TB,MIA,45,17,1,28
2021,2021_05_NO_WAS,REG,5,WAS,NO,22,33,0,-11
2021,2021_05_CLE_LAC,REG,5,LAC,CLE,47,42,1,5
2021,2021_05_CHI_LV,REG,5,LV,CHI,9,20,0,-11
2021,2021_05_SF_ARI,REG,5,ARI,SF,17,10,1,7
2021,2021_05_NYG_DAL,REG,5,DAL,NYG,44,20,1,24
2021,2021_05_BUF_KC,REG,5,KC,BUF,20,38,0,-18
2021,2021_05_IND_BAL,REG,5,BAL,IND,31,25,1,6
2021,2021_06_TB_PHI,REG,6,PHI,TB,22,28,0,-6
2021,2021_06_MIA_JAX,REG,6,JAX,MIA,23,20,1,3
2021,2021_06_LAC_BAL,REG,6,BAL,LAC,34,6,1,28
2021,2021_06_MIN_CAR,REG,6,CAR,MIN,28,34,0,-6
2021,2021_06_GB_CHI,REG,6,CHI,GB,14,24,0,-10
2021,2021_06_CIN_DET,REG,6,DET,CIN,11,34,0,-23
2021,2021_06_HOU_IND,REG,6,IND,HOU,31,3,1,28
2021,2021_06_LA_NYG,REG,6,NYG,LA,11,38,0,-27
2021,2021_06_KC_WAS,REG,6,WAS,KC,13,31,0,-18
2021,2021_06_ARI_CLE,REG,6,CLE,ARI,14,37,0,-23
2021,2021_06_LV_DEN,REG,6,DEN,LV,24,34,0,-10
2021,2021_06_DAL_NE,REG,6,NE,DAL,29,35,0,-6
2021,2021_06_SEA_PIT,REG,6,PIT,SEA,23,20,1,3
2021,2021_06_BUF_TEN,REG,6,TEN,BUF,34,31,1,3
2021,2021_07_DEN_CLE,REG,7,CLE,DEN,17,14,1,3
2021,2021_07_CIN_BAL,REG,7,BAL,CIN,17,41,0,-24
2021,2021_07_WAS_GB,REG,7,GB,WAS,24,10,1,14
2021,2021_07_ATL_MIA,REG,7,MIA,ATL,28,30,0,-2
2021,2021_07_NYJ_NE,REG,7,NE,NYJ,54,13,1,41
2021,2021_07_CAR_NYG,REG,7,NYG,CAR,25,3,1,22
2021,2021_07_KC_TEN,REG,7,TEN,KC,27,3,1,24
2021,2021_07_DET_LA,REG,7,LA,DET,28,19,1,9
2021,2021_07_PHI_LV,REG,7,LV,PHI,33,22,1,11
2021,2021_07_HOU_ARI,REG,7,ARI,HOU,31,5,1,26
2021,2021_07_CHI_TB,REG,7,TB,CHI,38,3,1,35
2021,2021_07_IND_SF,REG,7,SF,IND,18,30,0,-12
2021,2021_07_NO_SEA,REG,7,SEA,NO,10,13,0,-3
2021,2021_08_GB_ARI,REG,8,ARI,GB,21,24,0,-3
2021,2021_08_CAR_ATL,REG,8,ATL,CAR,13,19,0,-6
2021,2021_08_MIA_BUF,REG,8,BUF,MIA,26,11,1,15
2021,2021_08_SF_CHI,REG,8,CHI,SF,22,33,0,-11
2021,2021_08_PIT_CLE,REG,8,CLE,PIT,10,15,0,-5
2021,2021_08_PHI_DET,REG,8,DET,PHI,6,44,0,-38
2021,2021_08_LA_HOU,REG,8,HOU,LA,22,38,0,-16
2021,2021_08_TEN_IND,REG,8,IND,TEN,31,34,0,-3
2021,2021_08_CIN_NYJ,REG,8,NYJ,CIN,34,31,1,3
2021,2021_08_NE_LAC,REG,8,LAC,NE,24,27,0,-3
2021,2021_08_JAX_SEA,REG,8,SEA,JAX,31,7,1,24
2021,2021_08_WAS_DEN,REG,8,DEN,WAS,17,10,1,7
2021,2021_08_TB_NO,REG,8,NO,TB,36,27,1,9
2021,2021_08_DAL_MIN,REG,8,MIN,DAL,16,20,0,-4
2021,2021_08_NYG_KC,REG,8,KC,NYG,20,17,1,3
2021,2021_09_NYJ_IND,REG,9,IND,NYJ,45,30,1,15
2021,2021_09_MIN_BAL,REG,9,BAL,MIN,34,31,1,3
2021,2021_09_NE_CAR,REG,9,CAR,NE,6,24,0,-18
2021,2021_09_CLE_CIN,REG,9,CIN,CLE,16,41,0,-25
2021,2021_09_DEN_DAL,REG,9,DAL,DEN,16,30,0,-14
2021,2021_09_BUF_JAX,REG,9,JAX,BUF,9,6,1,3
2021,2021_09_HOU_MIA,REG,9,MIA,HOU,17,9,1,8
2021,2021_09_ATL_NO,REG,9,NO,ATL,25,27,0,-2
2021,2021_09_LV_NYG,REG,9,NYG,LV,23,16,1,7
2021,2021_09_LAC_PHI,REG,9,PHI,LAC,24,27,0,-3
2021,2021_09_GB_KC,REG,9,KC,GB,13,7,1,6
2021,2021_09_ARI_SF,REG,9,SF,ARI,17,31,0,-14
2021,2021_09_TEN_LA,REG,9,LA,TEN,16,28,0,-12
2021,2021_09_CHI_PIT,REG,9,PIT,CHI,29,27,1,2
2021,2021_10_BAL_MIA,REG,10,MIA,BAL,22,10,1,12
2021,2021_10_ATL_DAL,REG,10,DAL,ATL,43,3,1,40
2021,2021_10_JAX_IND,REG,10,IND,JAX,23,17,1,6
2021,2021_10_CLE_NE,REG,10,NE,CLE,45,7,1,38
2021,2021_10_BUF_NYJ,REG,10,NYJ,BUF,17,45,0,-28
2021,2021_10_DET_PIT,REG,10,PIT,DET,16,16,0.5,0
2021,2021_10_NO_TEN,REG,10,TEN,NO,23,21,1,2
2021,2021_10_TB_WAS,REG,10,WAS,TB,29,19,1,10
2021,2021_10_CAR_ARI,REG,10,ARI,CAR,10,34,0,-24
2021,2021_10_MIN_LAC,REG,10,LAC,MIN,20,27,0,-7
2021,2021_10_PHI_DEN,REG,10,DEN,PHI,13,30,0,-17
2021,2021_10_SEA_GB,REG,10,GB,SEA,17,0,1,17
2021,2021_10_KC_LV,REG,10,LV,KC,14,41,0,-27
2021,2021_10_LA_SF,REG,10,SF,LA,31,10,1,21
2021,2021_11_NE_ATL,REG,11,ATL,NE,0,25,0,-25
2021,2021_11_IND_BUF,REG,11,BUF,IND,15,41,0,-26
2021,2021_11_WAS_CAR,REG,11,CAR,WAS,21,27,0,-6
2021,2021_11_BAL_CHI,REG,11,CHI,BAL,13,16,0,-3
2021,2021_11_DET_CLE,REG,11,CLE,DET,13,10,1,3
2021,2021_11_SF_JAX,REG,11,JAX,SF,10,30,0,-20
2021,2021_11_GB_MIN,REG,11,MIN,GB,34,31,1,3
2021,2021_11_MIA_NYJ,REG,11,NYJ,MIA,17,24,0,-7
2021,2021_11_NO_PHI,REG,11,PHI,NO,40,29,1,11
2021,2021_11_HOU_TEN,REG,11,TEN,HOU,13,22,0,-9
2021,2021_11_CIN_LV,REG,11,LV,CIN,13,32,0,-19
2021,2021_11_DAL_KC,REG,11,KC,DAL,19,9,1,10
2021,2021_11_ARI_SEA,REG,11,SEA,ARI,13,23,0,-10
2021,2021_11_PIT_LAC,REG,11,LAC,PIT,41,37,1,4
2021,2021_11_NYG_TB,REG,11,TB,NYG,30,10,1,20
2021,2021_12_CHI_DET,REG,12,DET,CHI,14,16,0,-2
2021,2021_12_LV_DAL,REG,12,DAL,LV,33,36,0,-3
2021,2021_12_BUF_NO,REG,12,NO,BUF,6,31,0,-25
2021,2021_12_PIT_CIN,REG,12,CIN,PIT,41,10,1,31
2021,2021_12_NYJ_HOU,REG,12,HOU,NYJ,14,21,0,-7
2021,2021_12_TB_IND,REG,12,IND,TB,31,38,0,-7
2021,2021_12_ATL_JAX,REG,12,JAX,ATL,14,21,0,-7
2021,2021_12_CAR_MIA,REG,12,MIA,CAR,33,10,1,23
2021,2021_12_TEN_NE,REG,12,NE,TEN,36,13,1,23
2021,2021_12_PHI_NYG,REG,12,NYG,PHI,13,7,1,6
2021,2021_12_LAC_DEN,REG,12,DEN,LAC,28,13,1,15
2021,2021_12_LA_GB,REG,12,GB,LA,36,28,1,8
2021,2021_12_MIN_SF,REG,12,SF,MIN,34,26,1,8
2021,2021_12_CLE_BAL,REG,12,BAL,CLE,16,10,1,6
2021,2021_12_SEA_WAS,REG,12,WAS,SEA,17,15,1,2
2021,2021_13_DAL_NO,REG,13,NO,DAL,17,27,0,-10
2021,2021_13_TB_ATL,REG,13,ATL,TB,17,30,0,-13
2021,2021_13_ARI_CHI,REG,13,CHI,ARI,22,33,0,-11
2021,2021_13_LAC_CIN,REG,13,CIN,LAC,22,41,0,-19
2021,2021_13_MIN_DET,REG,13,DET,MIN,29,27,1,2
2021,2021_13_IND_HOU,REG,13,HOU,IND,0,31,0,-31
2021,2021_13_NYG_MIA,REG,13,MIA,NYG,20,9,1,11
2021,2021_13_PHI_NYJ,REG,13,NYJ,PHI,18,33,0,-15
2021,2021_13_JAX_LA,REG,13,LA,JAX,37,7,1,30
2021,2021_13_WAS_LV,REG,13,LV,WAS,15,17,0,-2
2021,2021_13_BAL_PIT,REG,13,PIT,BAL,20,19,1,1
2021,2021_13_SF_SEA,REG,13,SEA,SF,30,23,1,7
2021,2021_13_DEN_KC,REG,13,KC,DEN,22,9,1,13
2021,2021_13_NE_BUF,REG,13,BUF,NE,10,14,0,-4
2021,2021_14_PIT_MIN,REG,14,MIN,PIT,36,28,1,8
2021,2021_14_ATL_CAR,REG,14,CAR,ATL,21,29,0,-8
2021,2021_14_BAL_CLE,REG,14,CLE,BAL,24,22,1,2
2021,2021_14_SEA_HOU,REG,14,HOU,SEA,13,33,0,-20
2021,2021_14_LV_KC,REG,14,KC,LV,48,9,1,39
2021,2021_14_NO_NYJ,REG,14,NYJ,NO,9,30,0,-21
2021,2021_14_JAX_TEN,REG,14,TEN,JAX,20,0,1,20
2021,2021_14_DAL_WAS,REG,14,WAS,DAL,20,27,0,-7
2021,2021_14_DET_DEN,REG,14,DEN,DET,38,10,1,28
2021,2021_14_NYG_LAC,REG,14,LAC,NYG,37,21,1,16
2021,2021_14_SF_CIN,REG,14,CIN,SF,23,26,0,-3
2021,2021_14_BUF_TB,REG,14,TB,BUF,33,27,1,6
2021,2021_14_CHI_GB,REG,14,GB,CHI,45,30,1,15
2021,2021_14_LA_ARI,REG,14,ARI,LA,23,30,0,-7
2021,2021_15_KC_LAC,REG,15,LAC,KC,28,34,0,-6
2021,2021_15_NE_IND,REG,15,IND,NE,27,17,1,10
2021,2021_15_CAR_BUF,REG,15,BUF,CAR,31,14,1,17
2021,2021_15_ARI_DET,REG,15,DET,ARI,30,12,1,18
2021,2021_15_HOU_JAX,REG,15,JAX,HOU,16,30,0,-14
2021,2021_15_NYJ_MIA,REG,15,MIA,NYJ,31,24,1,7
2021,2021_15_DAL_NYG,REG,15,NYG,DAL,6,21,0,-15
2021,2021_15_TEN_PIT,REG,15,PIT,TEN,19,13,1,6
2021,2021_15_CIN_DEN,REG,15,DEN,CIN,10,15,0,-5
2021,2021_15_ATL_SF,REG,15,SF,ATL,31,13,1,18
2021,2021_15_GB_BAL,REG,15,BAL,GB,30,31,0,-1
2021,2021_15_NO_TB,REG,15,TB,NO,0,9,0,-9
2021,2021_15_LV_CLE,REG,15,CLE,LV,14,16,0,-2
2021,2021_15_MIN_CHI,REG,15,CHI,MIN,9,17,0,-8
2021,2021_15_SEA_LA,REG,15,LA,SEA,20,10,1,10
2021,2021_15_WAS_PHI,REG,15,PHI,WAS,27,17,1,10
2021,2021_16_SF_TEN,REG,16,TEN,SF,20,17,1,3
2021,2021_16_CLE_GB,REG,16,GB,CLE,24,22,1,2
2021,2021_16_IND_ARI,REG,16,ARI,IND,16,22,0,-6
2021,2021_16_DET_ATL,REG,16,ATL,DET,20,16,1,4
2021,2021_16_TB_CAR,REG,16,CAR,TB,6,32,0,-26
2021,2021_16_BAL_CIN,REG,16,CIN,BAL,41,21,1,20
2021,2021_16_LAC_HOU,REG,16,HOU,LAC,41,29,1,12
2021,2021_16_LA_MIN,REG,16,MIN,LA,23,30,0,-7
2021,2021_16_BUF_NE,REG,16,NE,BUF,21,33,0,-12
2021,2021_16_JAX_NYJ,REG,16,NYJ,JAX,26,21,1,5
2021,2021_16_NYG_PHI,REG,16,PHI,NYG,34,10,1,24
2021,2021_16_CHI_SEA,REG,16,SEA,CHI,24,25,0,-1
2021,2021_16_PIT_KC,REG,16,KC,PIT,36,10,1,26
2021,2021_16_DEN_LV,REG,16,LV,DEN,17,13,1,4
2021,2021_16_WAS_DAL,REG,16,DAL,WAS,56,14,1,42
2021,2021_16_MIA_NO,REG,16,NO,MIA,3,20,0,-17
2021,2021_17_LA_BAL,REG,17,BAL,LA,19,20,0,-1
2021,2021_17_ATL_BUF,REG,17,BUF,ATL,29,15,1,14
2021,2021_17_NYG_CHI,REG,17,CHI,NYG,29,3,1,26
2021,2021_17_KC_CIN,REG,17,CIN,KC,34,31,1,3
2021,2021_17_LV_IND,REG,17,IND,LV,20,23,0,-3
2021,2021_17_JAX_NE,REG,17,NE,JAX,50,10,1,40
2021,2021_17_TB_NYJ,REG,17,NYJ,TB,24,28,0,-4
2021,2021_17_MIA_TEN,REG,17,TEN,MIA,34,3,1,31
2021,2021_17_PHI_WAS,REG,17,WAS,PHI,16,20,0,-4
2021,2021_17_DEN_LAC,REG,17,LAC,DEN,34,13,1,21
2021,2021_17_HOU_SF,REG,17,SF,HOU,23,7,1,16
2021,2021_17_ARI_DAL,REG,17,DAL,ARI,22,25,0,-3
2021,2021_17_CAR_NO,REG,17,NO,CAR,18,10,1,8
2021,2021_17_DET_SEA,REG,17,SEA,DET,51,29,1,22
2021,2021_17_MIN_GB,REG,17,GB,MIN,37,10,1,27
2021,2021_17_CLE_PIT,REG,17,PIT,CLE,26,14,1,12
2021,2021_18_KC_DEN,REG,18,DEN,KC,24,28,0,-4
2021,2021_18_DAL_PHI,REG,18,PHI,DAL,26,51,0,-25
2021,2021_18_PIT_BAL,REG,18,BAL,PIT,13,16,0,-3
2021,2021_18_CIN_CLE,REG,18,CLE,CIN,21,16,1,5
2021,2021_18_GB_DET,REG,18,DET,GB,37,30,1,7
2021,2021_18_TEN_HOU,REG,18,HOU,TEN,25,28,0,-3
2021,2021_18_IND_JAX,REG,18,JAX,IND,26,11,1,15
2021,2021_18_CHI_MIN,REG,18,MIN,CHI,31,17,1,14
2021,2021_18_WAS_NYG,REG,18,NYG,WAS,7,22,0,-15
2021,2021_18_SEA_ARI,REG,18,ARI,SEA,30,38,0,-8
2021,2021_18_NO_ATL,REG,18,ATL,NO,20,30,0,-10
2021,2021_18_NYJ_BUF,REG,18,BUF,NYJ,27,10,1,17
2021,2021_18_SF_LA,REG,18,LA,SF,24,27,0,-3
2021,2021_18_NE_MIA,REG,18,MIA,NE,33,24,1,9
2021,2021_18_CAR_TB,REG,18,TB,CAR,41,17,1,24
2021,2021_18_LAC_LV,REG,18,LV,LAC,35,32,1,3
2021,2021_19_LV_CIN,WC,19,CIN,LV,26,19,1,7
2021,2021_19_NE_BUF,WC,19,BUF,NE,47,17,1,30
2021,2021_19_PHI_TB,WC,19,TB,PHI,31,15,1,16
2021,2021_19_SF_DAL,WC,19,DAL,SF,17,23,0,-6
2021,2021_19_PIT_KC,WC,19,KC,PIT,42,21,1,21
2021,2021_19_ARI_LA,WC,19,LA,ARI,34,11,1,23
2021,2021_20_CIN_TEN,DIV,20,TEN,CIN,16,19,0,-3
2021,2021_20_SF_GB,DIV,20,GB,SF,10,13,0,-3
2021,2021_20_LA_TB,DIV,20,TB,LA,27,30,0,-3
2021,2021_20_BUF_KC,DIV,20,KC,BUF,42,36,1,6
2021,2021_21_CIN_KC,CON,21,KC,CIN,24,27,0,-3
2021,2021_21_SF_LA,CON,21,LA,SF,20,17,1,3
2021,2021_22_LA_CIN,SB,22,CIN,LA,20,23,0,-3
2022,2022_01_BUF_LA,REG,1,LA,BUF,10,31,0,-21
2022,2022_01_NO_ATL,REG,1,ATL,NO,26,27,0,-1
2022,2022_01_CLE_CAR,REG,1,CAR,CLE,24,26,0,-2
2022,2022_01_SF_CHI,REG,1,CHI,SF,19,10,1,9
2022,2022_01_PIT_CIN,REG,1,CIN,PIT,20,23,0,-3
2022,2022_01_PHI_DET,REG,1,DET,PHI,35,38,0,-3
2022,2022_01_IND_HOU,REG,1,HOU,IND,20,20,0.5,0
2022,2022_01_NE_MIA,REG,1,MIA,NE,20,7,1,13
2022,2022_01_BAL_NYJ,REG,1,NYJ,BAL,9,24,0,-15
2022,2022_01_JAX_WAS,REG,1,WAS,JAX,28,22,1,6
2022,2022_01_KC_ARI,REG,1,ARI,KC,21,44,0,-23
2022,2022_01_LV_LAC,REG,1,LAC,LV,24,19,1,5
2022,2022_01_GB_MIN,REG,1,MIN,GB,23,7,1,16
2022,2022_01_NYG_TEN,REG,1,TEN,NYG,20,21,0,-1
2022,2022_01_TB_DAL,REG,1,DAL,TB,3,19,0,-16
2022,2022_01_DEN_SEA,REG,1,SEA,DEN,17,16,1,1
2022,2022_02_LAC_KC,REG,2,KC,LAC,27,24,1,3
2022,2022_02_MIA_BAL,REG,2,BAL,MIA,38,42,0,-4
2022,2022_02_NYJ_CLE,REG,2,CLE,NYJ,30,31,0,-1
2022,2022_02_WAS_DET,REG,2,DET,WAS,36,27,1,9
2022,2022_02_IND_JAX,REG,2,JAX,IND,24,0,1,24
2022,2022_02_TB_NO,REG,2,NO,TB,10,20,0,-10
2022,2022_02_CAR_NYG,REG,2,NYG,CAR,19,16,1,3
2022,2022_02_NE_PIT,REG,2,PIT,NE,14,17,0,-3
2022,2022_02_ATL_LA,REG,2,LA,ATL,31,27,1,4
2022,2022_02_SEA_SF,REG,2,SF,SEA,27,7,1,20
2022,2022_02_CIN_DAL,REG,2,DAL,CIN,20,17,1,3
2022,2022_02_HOU_DEN,REG,2,DEN,HOU,16,9,1,7
2022,2022_02_ARI_LV,REG,2,LV,ARI,23,29,0,-6
2022,2022_02_CHI_GB,REG,2,GB,CHI,27,10,1,17
2022,2022_02_TEN_BUF,REG,2,BUF,TEN,41,7,1,34
2022,2022_02_MIN_PHI,REG,2,PHI,MIN,24,7,1,17
2022,2022_03_PIT_CLE,REG,3,CLE,PIT,29,17,1,12
2022,2022_03_NO_CAR,REG,3,CAR,NO,22,14,1,8
2022,2022_03_HOU_CHI,REG,3,CHI,HOU,23,20,1,3
2022,2022_03_KC_IND,REG,3,IND,KC,20,17,1,3
2022,2022_03_BUF_MIA,REG,3,MIA,BUF,21,19,1,2
2022,2022_03_DET_MIN,REG,3,MIN,DET,28,24,1,4
2022,2022_03_BAL_NE,REG,3,NE,BAL,26,37,0,-11
2022,2022_03_CIN_NYJ,REG,3,NYJ,CIN,12,27,0,-15
2022,2022_03_LV_TEN,REG,3,TEN,LV,24,22,1,2
2022,2022_03_PHI_WAS,REG,3,WAS,PHI,8,24,0,-16
2022,2022_03_JAX_LAC,REG,3,LAC,JAX,10,38,0,-28
2022,2022_03_LA_ARI,REG,3,ARI,LA,12,20,0,-8
2022,2022_03_ATL_SEA,REG,3,SEA,ATL,23,27,0,-4
2022,2022_03_GB_TB,REG,3,TB,GB,12,14,0,-2
2022,2022_03_SF_DEN,REG,3,DEN,SF,11,10,1,1
2022,2022_03_DAL_NYG,REG,3,NYG,DAL,16,23,0,-7
2022,2022_04_MIA_CIN,REG,4,CIN,MIA,27,15,1,12
2022,2022_04_MIN_NO,REG,4,NO,MIN,25,28,0,-3
2022,2022_04_CLE_ATL,REG,4,ATL,CLE,23,20,1,3
2022,2022_04_BUF_BAL,REG,4,BAL,BUF,20,23,0,-3
2022,2022_04_WAS_DAL,REG,4,DAL,WAS,25,10,1,15
2022,2022_04_SEA_DET,REG,4,DET,SEA,45,48,0,-3
2022,2022_04_LAC_HOU,REG,4,HOU,LAC,24,34,0,-10
2022,2022_04_TEN_IND,REG,4,IND,TEN,17,24,0,-7
2022,2022_04_CHI_NYG,REG,4,NYG,CHI,20,12,1,8
2022,2022_04_JAX_PHI,REG,4,PHI,JAX,29,21,1,8
2022,2022_04_NYJ_PIT,REG,4,PIT,NYJ,20,24,0,-4
2022,2022_04_ARI_CAR,REG,4,CAR,ARI,16,26,0,-10
2022,2022_04_NE_GB,REG,4,GB,NE,27,24,1,3
2022,2022_04_DEN_LV,REG,4,LV,DEN,32,23,1,9
2022,2022_04_KC_TB,REG,4,TB,KC,31,41,0,-10
2022,2022_04_LA_SF,REG,4,SF,LA,24,9,1,15
2022,2022_05_IND_DEN,REG,5,DEN,IND,9,12,0,-3
2022,2022_05_NYG_GB,REG,5,GB,NYG,22,27,0,-5
2022,2022_05_PIT_BUF,REG,5,BUF,PIT,38,3,1,35
2022,2022_05_LAC_CLE,REG,5,CLE,LAC,28,30,0,-2
2022,2022_05_HOU_JAX,REG,5,JAX,HOU,6,13,0,-7
2022,2022_05_CHI_MIN,REG,5,MIN,CHI,29,22,1,7
2022,2022_05_DET_NE,REG,5,NE,DET,29,0,1,29
2022,2022_05_SEA_NO,REG,5,NO,SEA,39,32,1,7
2022,2022_05_MIA_NYJ,REG,5,NYJ,MIA,40,17,1,23
2022,2022_05_ATL_TB,REG,5,TB,ATL,21,15,1,6
2022,2022_05_TEN_WAS,REG,5,WAS,TEN,17,21,0,-4
2022,2022_05_SF_CAR,REG,5,CAR,SF,15,37,0,-22
2022,2022_05_PHI_ARI,REG,5,ARI,PHI,17,20,0,-3
2022,2022_05_DAL_LA,REG,5,LA,DAL,10,22,0,-12
2022,2022_05_CIN_BAL,REG,5,BAL,CIN,19,17,1,2
2022,2022_05_LV_KC,REG,5,KC,LV,30,29,1,1
2022,2022_06_WAS_CHI,REG,6,CHI,WAS,7,12,0,-5
2022,2022_06_SF_ATL,REG,6,ATL,SF,28,14,1,14
2022,2022_06_NE_CLE,REG,6,CLE,NE,15,38,0,-23
2022,2022_06_NYJ_GB,REG,6,GB,NYJ,10,27,0,-17
2022,2022_06_JAX_IND,REG,6,IND,JAX,34,27,1,7
2022,2022_06_MIN_MIA,REG,6,MIA,MIN,16,24,0,-8
2022,2022_06_CIN_NO,REG,6,NO,CIN,26,30,0,-4
2022,2022_06_BAL_NYG,REG,6,NYG,BAL,24,20,1,4
2022,2022_06_TB_PIT,REG,6,PIT,TB,20,18,1,2
2022,2022_06_CAR_LA,REG,6,LA,CAR,24,10,1,14
2022,2022_06_ARI_SEA,REG,6,SEA,ARI,19,9,1,10
2022,2022_06_BUF_KC,REG,6,KC,BUF,20,24,0,-4
2022,2022_06_DAL_PHI,REG,6,PHI,DAL,26,17,1,9
2022,2022_06_DEN_LAC,REG,6,LAC,DEN,19,16,1,3
2022,2022_07_NO_ARI,REG,7,ARI,NO,42,34,1,8
2022,2022_07_CLE_BAL,REG,7,BAL,CLE,23,20,1,3
2022,2022_07_TB_CAR,REG,7,CAR,TB,21,3,1,18
2022,2022_07_ATL_CIN,REG,7,CIN,ATL,35,17,1,18
2022,2022_07_DET_DAL,REG,7,DAL,DET,24,6,1,18
2022,2022_07_NYG_JAX,REG,7,JAX,NYG,17,23,0,-6
2022,2022_07_IND_TEN,REG,7,TEN,IND,19,10,1,9
2022,2022_07_GB_WAS,REG,7,WAS,GB,23,21,1,2
2022,2022_07_NYJ_DEN,REG,7,DEN,NYJ,9,16,0,-7
2022,2022_07_HOU_LV,REG,7,LV,HOU,38,20,1,18
2022,2022_07_SEA_LAC,REG,7,LAC,SEA,23,37,0,-14
2022,2022_07_KC_SF,REG,7,SF,KC,23,44,0,-21
2022,2022_07_PIT_MIA,REG,7,MIA,PIT,16,10,1,6
2022,2022_07_CHI_NE,REG,7,NE,CHI,14,33,0,-19
2022,2022_08_BAL_TB,REG,8,TB,BAL,22,27,0,-5
2022,2022_08_DEN_JAX,REG,8,JAX,DEN,17,21,0,-4
2022,2022_08_CAR_ATL,REG,8,ATL,CAR,37,34,1,3
2022,2022_08_CHI_DAL,REG,8,DAL,CHI,49,29,1,20
2022,2022_08_MIA_DET,REG,8,DET,MIA,27,31,0,-4
2022,2022_08_ARI_MIN,REG,8,MIN,ARI,34,26,1,8
2022,2022_08_LV_NO,REG,8,NO,LV,24,0,1,24
2022,2022_08_NE_NYJ,REG,8,NYJ,NE,17,22,0,-5
2022,2022_08_PIT_PHI,REG,8,PHI,PIT,35,13,1,22
2022,2022_08_TEN_HOU,REG,8,HOU,TEN,10,17,0,-7
2022,2022_08_WAS_IND,REG,8,IND,WAS,16,17,0,-1
2022,2022_08_SF_LA,REG,8,LA,SF,14,31,0,-17
2022,2022_08_NYG_SEA,REG,8,SEA,NYG,27,13,1,14
2022,2022_08_GB_BUF,REG,8,BUF,GB,27,17,1,10
2022,2022_08_CIN_CLE,REG,8,CLE,CIN,32,13,1,19
2022,2022_09_PHI_HOU,REG,9,HOU,PHI,17,29,0,-12
2022,2022_09_LAC_ATL,REG,9,ATL,LAC,17,20,0,-3
2022,2022_09_MIA_CHI,REG,9,CHI,MIA,32,35,0,-3
2022,2022_09_CAR_CIN,REG,9,CIN,CAR,42,21,1,21
2022,2022_09_GB_DET,REG,9,DET,GB,15,9,1,6
2022,2022_09_LV_JAX,REG,9,JAX,LV,27,20,1,7
2022,2022_09_IND_NE,REG,9,NE,IND,26,3,1,23
2022,2022_09_BUF_NYJ,REG,9,NYJ,BUF,20,17,1,3
2022,2022_09_MIN_WAS,REG,9,WAS,MIN,17,20,0,-3
2022,2022_09_SEA_ARI,REG,9,ARI,SEA,21,31,0,-10
2022,2022_09_LA_TB,REG,9,TB,LA,16,13,1,3
2022,2022_09_TEN_KC,REG,9,KC,TEN,20,17,1,3
2022,2022_09_BAL_NO,REG,9,NO,BAL,13,27,0,-14
2022,2022_10_ATL_CAR,REG,10,CAR,ATL,25,15,1,10
2022,2022_10_SEA_TB,REG,10,TB,SEA,21,16,1,5
2022,2022_10_MIN_BUF,REG,10,BUF,MIN,30,33,0,-3
2022,2022_10_DET_CHI,REG,10,CHI,DET,30,31,0,-1
2022,2022_10_JAX_KC,REG,10,KC,JAX,27,17,1,10
2022,2022_10_CLE_MIA,REG,10,MIA,CLE,39,17,1,22
2022,2022_10_HOU_NYG,REG,10,NYG,HOU,24,16,1,8
2022,2022_10_NO_PIT,REG,10,PIT,NO,20,10,1,10
2022,2022_10_DEN_TEN,REG,10,TEN,DEN,17,10,1,7
2022,2022_10_IND_LV,REG,10,LV,IND,20,25,0,-5
2022,2022_10_DAL_GB,REG,10,GB,DAL,31,28,1,3
2022,2022_10_ARI_LA,REG,10,LA,ARI,17,27,0,-10
2022,2022_10_LAC_SF,REG,10,SF,LAC,22,16,1,6
2022,2022_10_WAS_PHI,REG,10,PHI,WAS,21,32,0,-11
2022,2022_11_TEN_GB,REG,11,GB,TEN,17,27,0,-10
2022,2022_11_CHI_ATL,REG,11,ATL,CHI,27,24,1,3
2022,2022_11_CAR_BAL,REG,11,BAL,CAR,13,3,1,10
2022,2022_11_CLE_BUF,REG,11,BUF,CLE,31,23,1,8
2022,2022_11_WAS_HOU,REG,11,HOU,WAS,10,23,0,-13
2022,2022_11_PHI_IND,REG,11,IND,PHI,16,17,0,-1
2022,2022_11_NYJ_NE,REG,11,NE,NYJ,10,3,1,7
2022,2022_11_LA_NO,REG,11,NO,LA,27,20,1,7
2022,2022_11_DET_NYG,REG,11,NYG,DET,18,31,0,-13
2022,2022_11_LV_DEN,REG,11,DEN,LV,16,22,0,-6
2022,2022_11_DAL_MIN,REG,11,MIN,DAL,3,40,0,-37
2022,2022_11_CIN_PIT,REG,11,PIT,CIN,30,37,0,-7
2022,2022_11_KC_LAC,REG,11,LAC,KC,27,30,0,-3
2022,2022_11_SF_ARI,REG,11,ARI,SF,10,38,0,-28
2022,2022_12_BUF_DET,REG,12,DET,BUF,25,28,0,-3
2022,2022_12_NYG_DAL,REG,12,DAL,NYG,28,20,1,8
2022,2022_12_NE_MIN,REG,12,MIN,NE,33,26,1,7
2022,2022_12_DEN_CAR,REG,12,CAR,DEN,23,10,1,13
2022,2022_12_TB_CLE,REG,12,CLE,TB,23,17,1,6
2022,2022_12_BAL_JAX,REG,12,JAX,BAL,28,27,1,1
2022,2022_12_HOU_MIA,REG,12,MIA,HOU,30,15,1,15
2022,2022_12_CHI_NYJ,REG,12,NYJ,CHI,31,10,1,21
2022,2022_12_CIN_TEN,REG,12,TEN,CIN,16,20,0,-4
2022,2022_12_ATL_WAS,REG,12,WAS,ATL,19,13,1,6
2022,2022_12_LAC_ARI,REG,12,ARI,LAC,24,25,0,-1
2022,2022_12_LV_SEA,REG,12,SEA,LV,34,40,0,-6
2022,2022_12_LA_KC,REG,12,KC,LA,26,10,1,16
2022,2022_12_NO_SF,REG,12,SF,NO,13,0,1,13
2022,2022_12_GB_PHI,REG,12,PHI,GB,40,33,1,7
2022,2022_12_PIT_IND,REG,12,IND,PIT,17,24,0,-7
2022,2022_13_BUF_NE,REG,13,NE,BUF,10,24,0,-14
2022,2022_13_PIT_ATL,REG,13,ATL,PIT,16,19,0,-3
2022,2022_13_DEN_BAL,REG,13,BAL,DEN,10,9,1,1
2022,2022_13_GB_CHI,REG,13,CHI,GB,19,28,0,-9
2022,2022_13_JAX_DET,REG,13,DET,JAX,40,14,1,26
2022,2022_13_CLE_HOU,REG,13,HOU,CLE,14,27,0,-13
2022,2022_13_NYJ_MIN,REG,13,MIN,NYJ,27,22,1,5
2022,2022_13_WAS_NYG,REG,13,NYG,WAS,20,20,0.5,0
2022,2022_13_TEN_PHI,REG,13,PHI,TEN,35,10,1,25
2022,2022_13_SEA_LA,REG,13,LA,SEA,23,27,0,-4
2022,2022_13_MIA_SF,REG,13,SF,MIA,33,17,1,16
2022,2022_13_KC_CIN,REG,13,CIN,KC,27,24,1,3
2022,2022_13_LAC_LV,REG,13,LV,LAC,27,20,1,7
2022,2022_13_IND_DAL,REG,13,DAL,IND,54,19,1,35
2022,2022_13_NO_TB,REG,13,TB,NO,17,16,1,1
2022,2022_14_LV_LA,REG,14,LA,LV,17,16,1,1
2022,2022_14_NYJ_BUF,REG,14,BUF,NYJ,20,12,1,8
2022,2022_14_CLE_CIN,REG,14,CIN,CLE,23,10,1,13
2022,2022_14_HOU_DAL,REG,14,DAL,HOU,27,23,1,4
2022,2022_14_MIN_DET,REG,14,DET,MIN,34,23,1,11
2022,2022_14_PHI_NYG,REG,14,NYG,PHI,22,48,0,-26
2022,2022_14_BAL_PIT,REG,14,PIT,BAL,14,16,0,-2
2022,2022_14_JAX_TEN,REG,14,TEN,JAX,22,36,0,-14
2022,2022_14_KC_DEN,REG,14,DEN,KC,28,34,0,-6
2022,2022_14_CAR_SEA,REG,14,SEA,CAR,24,30,0,-6
2022,2022_14_TB_SF,REG,14,SF,TB,35,7,1,28
2022,2022_14_MIA_LAC,REG,14,LAC,MIA,23,17,1,6
2022,2022_14_NE_ARI,REG,14,ARI,NE,13,27,0,-14
2022,2022_15_SF_SEA,REG,15,SEA,SF,13,21,0,-8
2022,2022_15_IND_MIN,REG,15,MIN,IND,39,36,1,3
2022,2022_15_BAL_CLE,REG,15,CLE,BAL,13,3,1,10
2022,2022_15_MIA_BUF,REG,15,BUF,MIA,32,29,1,3
2022,2022_15_PIT_CAR,REG,15,CAR,PIT,16,24,0,-8
2022,2022_15_PHI_CHI,REG,15,CHI,PHI,20,25,0,-5
2022,2022_15_KC_HOU,REG,15,HOU,KC,24,30,0,-6
2022,2022_15_DAL_JAX,REG,15,JAX,DAL,40,34,1,6
2022,2022_15_ATL_NO,REG,15,NO,ATL,21,18,1,3
2022,2022_15_DET_NYJ,REG,15,NYJ,DET,17,20,0,-3
2022,2022_15_ARI_DEN,REG,15,DEN,ARI,24,15,1,9
2022,2022_15_NE_LV,REG,15,LV,NE,30,24,1,6
2022,2022_15_TEN_LAC,REG,15,LAC,TEN,17,14,1,3
2022,2022_15_CIN_TB,REG,15,TB,CIN,23,34,0,-11
2022,2022_15_NYG_WAS,REG,15,WAS,NYG,12,20,0,-8
2022,2022_15_LA_GB,REG,15,GB,LA,24,12,1,12
2022,2022_16_JAX_NYJ,REG,16,NYJ,JAX,3,19,0,-16
2022,2022_16_ATL_BAL,REG,16,BAL,ATL,17,9,1,8
2022,2022_16_DET_CAR,REG,16,CAR,DET,37,23,1,14
2022,2022_16_BUF_CHI,REG,16,CHI,BUF,13,35,0,-22
2022,2022_16_NO_CLE,REG,16,CLE,NO,10,17,0,-7
2022,2022_16_SEA_KC,REG,16,KC,SEA,24,10,1,14
2022,2022_16_NYG_MIN,REG,16,MIN,NYG,27,24,1,3
2022,2022_16_CIN_NE,REG,16,NE,CIN,18,22,0,-4
2022,2022_16_HOU_TEN,REG,16,TEN,HOU,14,19,0,-5
2022,2022_16_WAS_SF,REG,16,SF,WAS,37,20,1,17
2022,2022_16_PHI_DAL,REG,16,DAL,PHI,40,34,1,6
2022,2022_16_LV_PIT,REG,16,PIT,LV,13,10,1,3
2022,2022_16_GB_MIA,REG,16,MIA,GB,20,26,0,-6
2022,2022_16_DEN_LA,REG,16,LA,DEN,51,14,1,37
2022,2022_16_TB_ARI,REG,16,ARI,TB,16,19,0,-3
2022,2022_16_LAC_IND,REG,16,IND,LAC,3,20,0,-17
2022,2022_17_DAL_TEN,REG,17,TEN,DAL,13,27,0,-14
2022,2022_17_ARI_ATL,REG,17,ATL,ARI,20,19,1,1
2022,2022_17_CHI_DET,REG,17,DET,CHI,41,10,1,31
2022,2022_17_JAX_HOU,REG,17,HOU,JAX,3,31,0,-28
2022,2022_17_DEN_KC,REG,17,KC,DEN,27,24,1,3
2022,2022_17_MIA_NE,REG,17,NE,MIA,23,21,1,2
2022,2022_17_IND_NYG,REG,17,NYG,IND,38,10,1,28
2022,2022_17_NO_PHI,REG,17,PHI,NO,10,20,0,-10
2022,2022_17_CAR_TB,REG,17,TB,CAR,30,24,1,6
2022,2022_17_CLE_WAS,REG,17,WAS,CLE,10,24,0,-14
2022,2022_17_SF_LV,REG,17,LV,SF,34,37,0,-3
2022,2022_17_NYJ_SEA,REG,17,SEA,NYJ,23,6,1,17
2022,2022_17_MIN_GB,REG,17,GB,MIN,41,17,1,24
2022,2022_17_LA_LAC,REG,17,LAC,LA,31,10,1,21
2022,2022_17_PIT_BAL,REG,17,BAL,PIT,13,16,0,-3
2022,2022_18_KC_LV,REG,18,LV,KC,13,31,0,-18
2022,2022_18_TEN_JAX,REG,18,JAX,TEN,20,16,1,4
2022,2022_18_TB_ATL,REG,18,ATL,TB,30,17,1,13
2022,2022_18_NE_BUF,REG,18,BUF,NE,35,23,1,12
2022,2022_18_MIN_CHI,REG,18,CHI,MIN,13,29,0,-16
2022,2022_18_BAL_CIN,REG,18,CIN,BAL,27,16,1,11
2022,2022_18_HOU_IND,REG,18,IND,HOU,31,32,0,-1
2022,2022_18_NYJ_MIA,REG,18,MIA,NYJ,11,6,1,5
2022,2022_18_CAR_NO,REG,18,NO,CAR,7,10,0,-3
2022,2022_18_CLE_PIT,REG,18,PIT,CLE,28,14,1,14
2022,2022_18_LAC_DEN,REG,18,DEN,LAC,31,28,1,3
2022,2022_18_NYG_PHI,REG,18,PHI,NYG,22,16,1,6
2022,2022_18_LA_SEA,REG,18,SEA,LA,19,16,1,3
2022,2022_18_ARI_SF,REG,18,SF,ARI,38,13,1,25
2022,2022_18_DAL_WAS,REG,18,WAS,DAL,26,6,1,20
2022,2022_18_DET_GB,REG,18,GB,DET,16,20,0,-4
2022,2022_19_SEA_SF,WC,19,SF,SEA,41,23,1,18
2022,2022_19_LAC_JAX,WC,19,JAX,LAC,31,30,1,1
2022,2022_19_MIA_BUF,WC,19,BUF,MIA,34,31,1,3
2022,2022_19_NYG_MIN,WC,19,MIN,NYG,24,31,0,-7
2022,2022_19_BAL_CIN,WC,19,CIN,BAL,24,17,1,7
2022,2022_19_DAL_TB,WC,19,TB,DAL,14,31,0,-17
2022,2022_20_JAX_KC,DIV,20,KC,JAX,27,20,1,7
2022,2022_20_NYG_PHI,DIV,20,PHI,NYG,38,7,1,31
2022,2022_20_CIN_BUF,DIV,20,BUF,CIN,10,27,0,-17
2022,2022_20_DAL_SF,DIV,20,SF,DAL,19,12,1,7
2022,2022_21_SF_PHI,CON,21,PHI,SF,31,7,1,24
2022,2022_21_CIN_KC,CON,21,KC,CIN,23,20,1,3
2022,2022_22_KC_PHI,SB,22,PHI,KC,35,38,0,-3
2023,2023_01_DET_KC,REG,1,KC,DET,20,21,0,-1
2023,2023_01_CAR_ATL,REG,1,ATL,CAR,24,10,1,14
2023,2023_01_HOU_BAL,REG,1,BAL,HOU,25,9,1,16
2023,2023_01_CIN_CLE,REG,1,CLE,CIN,24,3,1,21
2023,2023_01_JAX_IND,REG,1,IND,JAX,21,31,0,-10
2023,2023_01_TB_MIN,REG,1,MIN,TB,17,20,0,-3
2023,2023_01_TEN_NO,REG,1,NO,TEN,16,15,1,1
2023,2023_01_SF_PIT,REG,1,PIT,SF,7,30,0,-23
2023,2023_01_ARI_WAS,REG,1,WAS,ARI,20,16,1,4
2023,2023_01_GB_CHI,REG,1,CHI,GB,20,38,0,-18
2023,2023_01_LV_DEN,REG,1,DEN,LV,16,17,0,-1
2023,2023_01_MIA_LAC,REG,1,LAC,MIA,34,36,0,-2
2023,2023_01_PHI_NE,REG,1,NE,PHI,20,25,0,-5
2023,2023_01_LA_SEA,REG,1,SEA,LA,13,30,0,-17
2023,2023_01_DAL_NYG,REG,1,NYG,DAL,0,40,0,-40
2023,2023_01_BUF_NYJ,REG,1,NYJ,BUF,22,16,1,6
2023,2023_02_MIN_PHI,REG,2,PHI,MIN,34,28,1,6
2023,2023_02_GB_ATL,REG,2,ATL,GB,25,24,1,1
2023,2023_02_LV_BUF,REG,2,BUF,LV,38,10,1,28
2023,2023_02_BAL_CIN,REG,2,CIN,BAL,24,27,0,-3
2023,2023_02_SEA_DET,REG,2,DET,SEA,31,37,0,-6
2023,2023_02_IND_HOU,REG,2,HOU,IND,20,31,0,-11
2023,2023_02_KC_JAX,REG,2,JAX,KC,9,17,0,-8
2023,2023_02_CHI_TB,REG,2,TB,CHI,27,17,1,10
2023,2023_02_LAC_TEN,REG,2,TEN,LAC,27,24,1,3
2023,2023_02_NYG_ARI,REG,2,ARI,NYG,28,31,0,-3
2023,2023_02_SF_LA,REG,2,LA,SF,23,30,0,-7
2023,2023_02_NYJ_DAL,REG,2,DAL,NYJ,30,10,1,20
2023,2023_02_WAS_DEN,REG,2,DEN,WAS,33,35,0,-2
2023,2023_02_MIA_NE,REG,2,NE,MIA,17,24,0,-7
2023,2023_02_NO_CAR,REG,2,CAR,NO,17,20,0,-3
2023,2023_02_CLE_PIT,REG,2,PIT,CLE,26,22,1,4
2023,2023_03_NYG_SF,REG,3,SF,NYG,30,12,1,18
2023,2023_03_IND_BAL,REG,3,BAL,IND,19,22,0,-3
2023,2023_03_TEN_CLE,REG,3,CLE,TEN,27,3,1,24
2023,2023_03_ATL_DET,REG,3,DET,ATL,20,6,1,14
2023,2023_03_NO_GB,REG,3,GB,NO,18,17,1,1
2023,2023_03_HOU_JAX,REG,3,JAX,HOU,17,37,0,-20
2023,2023_03_DEN_MIA,REG,3,MIA,DEN,70,20,1,50
2023,2023_03_LAC_MIN,REG,3,MIN,LAC,24,28,0,-4
2023,2023_03_NE_NYJ,REG,3,NYJ,NE,10,15,0,-5
2023,2023_03_BUF_WAS,REG,3,WAS,BUF,3,37,0,-34
2023,2023_03_CAR_SEA,REG,3,SEA,CAR,37,27,1,10
2023,2023_03_DAL_ARI,REG,3,ARI,DAL,28,16,1,12
2023,2023_03_CHI_KC,REG,3,KC,CHI,41,10,1,31
2023,2023_03_PIT_LV,REG,3,LV,PIT,18,23,0,-5
2023,2023_03_PHI_TB,REG,3,TB,PHI,11,25,0,-14
2023,2023_03_LA_CIN,REG,3,CIN,LA,19,16,1,3
2023,2023_04_DET_GB,REG,4,GB,DET,20,34,0,-14
2023,2023_04_ATL_JAX,REG,4,JAX,ATL,23,7,1,16
2023,2023_04_MIA_BUF,REG,4,BUF,MIA,48,20,1,28
2023,2023_04_MIN_CAR,REG,4,CAR,MIN,13,21,0,-8
2023,2023_04_DEN_CHI,REG,4,CHI,DEN,28,31,0,-3
2023,2023_04_BAL_CLE,REG,4,CLE,BAL,3,28,0,-25
2023,2023_04_PIT_HOU,REG,4,HOU,PIT,30,6,1,24
2023,2023_04_LA_IND,REG,4,IND,LA,23,29,0,-6
2023,2023_04_TB_NO,REG,4,NO,TB,9,26,0,-17
2023,2023_04_WAS_PHI,REG,4,PHI,WAS,34,31,1,3
2023,2023_04_CIN_TEN,REG,4,TEN,CIN,27,3,1,24
2023,2023_04_LV_LAC,REG,4,LAC,LV,24,17,1,7
2023,2023_04_NE_DAL,REG,4,DAL,NE,38,3,1,35
2023,2023_04_ARI_SF,REG,4,SF,ARI,35,16,1,19
2023,2023_04_KC_NYJ,REG,4,NYJ,KC,20,23,0,-3
2023,2023_04_SEA_NYG,REG,4,NYG,SEA,3,24,0,-21
2023,2023_05_CHI_WAS,REG,5,WAS,CHI,20,40,0,-20
2023,2023_05_JAX_BUF,REG,5,BUF,JAX,20,25,0,-5
2023,2023_05_HOU_ATL,REG,5,ATL,HOU,21,19,1,2
2023,2023_05_CAR_DET,REG,5,DET,CAR,42,24,1,18
2023,2023_05_TEN_IND,REG,5,IND,TEN,23,16,1,7
2023,2023_05_NYG_MIA,REG,5,MIA,NYG,31,16,1,15
2023,2023_05_NO_NE,REG,5,NE,NO,0,34,0,-34
2023,2023_05_BAL_PIT,REG,5,PIT,BAL,17,10,1,7
2023,2023_05_CIN_ARI,REG,5,ARI,CIN,20,34,0,-14
2023,2023_05_PHI_LA,REG,5,LA,PHI,14,23,0,-9
2023,2023_05_NYJ_DEN,REG,5,DEN,NYJ,21,31,0,-10
2023,2023_05_KC_MIN,REG,5,MIN,KC,20,27,0,-7
2023,2023_05_DAL_SF,REG,5,SF,DAL,42,10,1,32
2023,2023_05_GB_LV,REG,5,LV,GB,17,13,1,4
2023,2023_06_DEN_KC,REG,6,KC,DEN,19,8,1,11
2023,2023_06_BAL_TEN,REG,6,TEN,BAL,16,24,0,-8
2023,2023_06_WAS_ATL,REG,6,ATL,WAS,16,24,0,-8
2023,2023_06_MIN_CHI,REG,6,CHI,MIN,13,19,0,-6
2023,2023_06_SEA_CIN,REG,6,CIN,SEA,17,13,1,4
2023,2023_06_SF_CLE,REG,6,CLE,SF,19,17,1,2
2023,2023_06_NO_HOU,REG,6,HOU,NO,20,13,1,7
2023,2023_06_IND_JAX,REG,6,JAX,IND,37,20,1,17
2023,2023_06_CAR_MIA,REG,6,MIA,CAR,42,21,1,21
2023,2023_06_NE_LV,REG,6,LV,NE,21,17,1,4
2023,2023_06_ARI_LA,REG,6,LA,ARI,26,9,1,17
2023,2023_06_PHI_NYJ,REG,6,NYJ,PHI,20,14,1,6
2023,2023_06_DET_TB,REG,6,TB,DET,6,20,0,-14
2023,2023_06_NYG_BUF,REG,6,BUF,NYG,14,9,1,5
2023,2023_06_DAL_LAC,REG,6,LAC,DAL,17,20,0,-3
2023,2023_07_JAX_NO,REG,7,NO,JAX,24,31,0,-7
2023,2023_07_DET_BAL,REG,7,BAL,DET,38,6,1,32
2023,2023_07_LV_CHI,REG,7,CHI,LV,30,12,1,18
2023,2023_07_CLE_IND,REG,7,IND,CLE,38,39,0,-1
2023,2023_07_BUF_NE,REG,7,NE,BUF,29,25,1,4
2023,2023_07_WAS_NYG,REG,7,NYG,WAS,14,7,1,7
2023,2023_07_ATL_TB,REG,7,TB,ATL,13,16,0,-3
2023,2023_07_PIT_LA,REG,7,LA,PIT,17,24,0,-7
2023,2023_07_ARI_SEA,REG,7,SEA,ARI,20,10,1,10
2023,2023_07_GB_DEN,REG,7,DEN,GB,19,17,1,2
2023,2023_07_LAC_KC,REG,7,KC,LAC,31,17,1,14
2023,2023_07_MIA_PHI,REG,7,PHI,MIA,31,17,1,14
2023,2023_07_SF_MIN,REG,7,MIN,SF,22,17,1,5
2023,2023_08_TB_BUF,REG,8,BUF,TB,24,18,1,6
2023,2023_08_HOU_CAR,REG,8,CAR,HOU,15,13,1,2
2023,2023_08_LA_DAL,REG,8,DAL,LA,43,20,1,23
2023,2023_08_MIN_GB,REG,8,GB,MIN,10,24,0,-14
2023,2023_08_NO_IND,REG,8,IND,NO,27,38,0,-11
2023,2023_08_NE_MIA,REG,8,MIA,NE,31,17,1,14
2023,2023_08_NYJ_NYG,REG,8,NYG,NYJ,10,13,0,-3
2023,2023_08_JAX_PIT,REG,8,PIT,JAX,10,20,0,-10
2023,2023_08_ATL_TEN,REG,8,TEN,ATL,28,23,1,5
2023,2023_08_PHI_WAS,REG,8,WAS,PHI,31,38,0,-7
2023,2023_08_CLE_SEA,REG,8,SEA,CLE,24,20,1,4
2023,2023_08_BAL_ARI,REG,8,ARI,BAL,24,31,0,-7
2023,2023_08_KC_DEN,REG,8,DEN,KC,24,9,1,15
2023,2023_08_CIN_SF,REG,8,SF,CIN,17,31,0,-14
2023,2023_08_CHI_LAC,REG,8,LAC,CHI,30,13,1,17
2023,2023_08_LV_DET,REG,8,DET,LV,26,14,1,12
2023,2023_09_TEN_PIT,REG,9,PIT,TEN,20,16,1,4
2023,2023_09_MIA_KC,REG,9,KC,MIA,21,14,1,7
2023,2023_09_MIN_ATL,REG,9,ATL,MIN,28,31,0,-3
2023,2023_09_SEA_BAL,REG,9,BAL,SEA,37,3,1,34
2023,2023_09_ARI_CLE,REG,9,CLE,ARI,27,0,1,27
2023,2023_09_LA_GB,REG,9,GB,LA,20,3,1,17
2023,2023_09_TB_HOU,REG,9,HOU,TB,39,37,1,2
2023,2023_09_WAS_NE,REG,9,NE,WAS,17,20,0,-3
2023,2023_09_CHI_NO,REG,9,NO,CHI,24,17,1,7
2023,2023_09_IND_CAR,REG,9,CAR,IND,13,27,0,-14
2023,2023_09_NYG_LV,REG,9,LV,NYG,30,6,1,24
2023,2023_09_DAL_PHI,REG,9,PHI,DAL,28,23,1,5
2023,2023_09_BUF_CIN,REG,9,CIN,BUF,24,18,1,6
2023,2023_09_LAC_NYJ,REG,9,NYJ,LAC,6,27,0,-21
2023,2023_10_CAR_CHI,REG,10,CHI,CAR,16,13,1,3
2023,2023_10_IND_NE,REG,10,NE,IND,6,10,0,-4
2023,2023_10_CLE_BAL,REG,10,BAL,CLE,31,33,0,-2
2023,2023_10_HOU_CIN,REG,10,CIN,HOU,27,30,0,-3
2023,2023_10_SF_JAX,REG,10,JAX,SF,3,34,0,-31
2023,2023_10_NO_MIN,REG,10,MIN,NO,27,19,1,8
2023,2023_10_GB_PIT,REG,10,PIT,GB,23,19,1,4
2023,2023_10_TEN_TB,REG,10,TB,TEN,20,6,1,14
2023,2023_10_ATL_ARI,REG,10,ARI,ATL,25,23,1,2
2023,2023_10_DET_LAC,REG,10,LAC,DET,38,41,0,-3
2023,2023_10_NYG_DAL,REG,10,DAL,NYG,49,17,1,32
2023,2023_10_WAS_SEA,REG,10,SEA,WAS,29,26,1,3
2023,2023_10_NYJ_LV,REG,10,LV,NYJ,16,12,1,4
2023,2023_10_DEN_BUF,REG,10,BUF,DEN,22,24,0,-2
2023,2023_11_CIN_BAL,REG,11,BAL,CIN,34,20,1,14
2023,2023_11_DAL_CAR,REG,11,CAR,DAL,10,33,0,-23
2023,2023_11_PIT_CLE,REG,11,CLE,PIT,13,10,1,3
2023,2023_11_CHI_DET,REG,11,DET,CHI,31,26,1,5
2023,2023_11_LAC_GB,REG,11,GB,LAC,23,20,1,3
2023,2023_11_ARI_HOU,REG,11,HOU,ARI,21,16,1,5
2023,2023_11_TEN_JAX,REG,11,JAX,TEN,34,14,1,20
2023,2023_11_LV_MIA,REG,11,MIA,LV,20,13,1,7
2023,2023_11_NYG_WAS,REG,11,WAS,NYG,19,31,0,-12
2023,2023_11_TB_SF,REG,11,SF,TB,27,14,1,13
2023,2023_11_NYJ_BUF,REG,11,BUF,NYJ,32,6,1,26
2023,2023_11_SEA_LA,REG,11,LA,SEA,17,16,1,1
2023,2023_11_MIN_DEN,REG,11,DEN,MIN,21,20,1,1
2023,2023_11_PHI_KC,REG,11,KC,PHI,17,21,0,-4
2023,2023_12_GB_DET,REG,12,DET,GB,22,29,0,-7
2023,2023_12_WAS_DAL,REG,12,DAL,WAS,45,10,1,35
2023,2023_12_SF_SEA,REG,12,SEA,SF,13,31,0,-18
2023,2023_12_MIA_NYJ,REG,12,NYJ,MIA,13,34,0,-21
2023,2023_12_NO_ATL,REG,12,ATL,NO,24,15,1,9
2023,2023_12_PIT_CIN,REG,12,CIN,PIT,10,16,0,-6
2023,2023_12_JAX_HOU,REG,12,HOU,JAX,21,24,0,-3
2023,2023_12_TB_IND,REG,12,IND,TB,27,20,1,7
2023,2023_12_NE_NYG,REG,12,NYG,NE,10,7,1,3
2023,2023_12_CAR_TEN,REG,12,TEN,CAR,17,10,1,7
2023,2023_12_LA_ARI,REG,12,ARI,LA,14,37,0,-23
2023,2023_12_CLE_DEN,REG,12,DEN,CLE,29,12,1,17
2023,2023_12_KC_LV,REG,12,LV,KC,17,31,0,-14
2023,2023_12_BUF_PHI,REG,12,PHI,BUF,37,34,1,3
2023,2023_12_BAL_LAC,REG,12,LAC,BAL,10,20,0,-10
2023,2023_12_CHI_MIN,REG,12,MIN,CHI,10,12,0,-2
2023,2023_13_SEA_DAL,REG,13,DAL,SEA,41,35,1,6
2023,2023_13_DEN_HOU,REG,13,HOU,DEN,22,17,1,5
2023,2023_13_LAC_NE,REG,13,NE,LAC,0,6,0,-6
2023,2023_13_DET_NO,REG,13,NO,DET,28,33,0,-5
2023,2023_13_ATL_NYJ,REG,13,NYJ,ATL,8,13,0,-5
2023,2023_13_ARI_PIT,REG,13,PIT,ARI,10,24,0,-14
2023,2023_13_IND_TEN,REG,13,TEN,IND,28,31,0,-3
2023,2023_13_MIA_WAS,REG,13,WAS,MIA,15,45,0,-30
2023,2023_13_CAR_TB,REG,13,TB,CAR,21,18,1,3
2023,2023_13_CLE_LA,REG,13,LA,CLE,36,19,1,17
2023,2023_13_SF_PHI,REG,13,PHI,SF,19,42,0,-23
2023,2023_13_KC_GB,REG,13,GB,KC,27,19,1,8
2023,2023_13_CIN_JAX,REG,13,JAX,CIN,31,34,0,-3
2023,2023_14_NE_PIT,REG,14,PIT,NE,18,21,0,-3
2023,2023_14_TB_ATL,REG,14,ATL,TB,25,29,0,-4
2023,2023_14_LA_BAL,REG,14,BAL,LA,37,31,1,6
2023,2023_14_DET_CHI,REG,14,CHI,DET,28,13,1,15
2023,2023_14_IND_CIN,REG,14,CIN,IND,34,14,1,20
2023,2023_14_JAX_CLE,REG,14,CLE,JAX,31,27,1,4
2023,2023_14_CAR_NO,REG,14,NO,CAR,28,6,1,22
2023,2023_14_HOU_NYJ,REG,14,NYJ,HOU,30,6,1,24
2023,2023_14_MIN_LV,REG,14,LV,MIN,0,3,0,-3
2023,2023_14_SEA_SF,REG,14,SF,SEA,28,16,1,12
2023,2023_14_BUF_KC,REG,14,KC,BUF,17,20,0,-3
2023,2023_14_DEN_LAC,REG,14,LAC,DEN,7,24,0,-17
2023,2023_14_PHI_DAL,REG,14,DAL,PHI,33,13,1,20
2023,2023_14_TEN_MIA,REG,14,MIA,TEN,27,28,0,-1
2023,2023_14_GB_NYG,REG,14,NYG,GB,24,22,1,2
2023,2023_15_LAC_LV,REG,15,LV,LAC,63,21,1,42
2023,2023_15_MIN_CIN,REG,15,CIN,MIN,27,24,1,3
2023,2023_15_PIT_IND,REG,15,IND,PIT,30,13,1,17
2023,2023_15_DEN_DET,REG,15,DET,DEN,42,17,1,25
2023,2023_15_ATL_CAR,REG,15,CAR,ATL,9,7,1,2
2023,2023_15_CHI_CLE,REG,15,CLE,CHI,20,17,1,3
2023,2023_15_TB_GB,REG,15,GB,TB,20,34,0,-14
2023,2023_15_NYJ_MIA,REG,15,MIA,NYJ,30,0,1,30
2023,2023_15_KC_NE,REG,15,NE,KC,17,27,0,-10
2023,2023_15_NYG_NO,REG,15,NO,NYG,24,6,1,18
2023,2023_15_HOU_TEN,REG,15,TEN,HOU,16,19,0,-3
2023,2023_15_SF_ARI,REG,15,ARI,SF,29,45,0,-16
2023,2023_15_WAS_LA,REG,15,LA,WAS,28,20,1,8
2023,2023_15_DAL_BUF,REG,15,BUF,DAL,31,10,1,21
2023,2023_15_BAL_JAX,REG,15,JAX,BAL,7,23,0,-16
2023,2023_15_PHI_SEA,REG,15,SEA,PHI,20,17,1,3
2023,2023_16_NO_LA,REG,16,LA,NO,30,22,1,8
2023,2023_16_CIN_PIT,REG,16,PIT,CIN,34,11,1,23
2023,2023_16_BUF_LAC,REG,16,LAC,BUF,22,24,0,-2
2023,2023_16_IND_ATL,REG,16,ATL,IND,29,10,1,19
2023,2023_16_GB_CAR,REG,16,CAR,GB,30,33,0,-3
2023,2023_16_CLE_HOU,REG,16,HOU,CLE,22,36,0,-14
2023,2023_16_DET_MIN,REG,16,MIN,DET,24,30,0,-6
2023,2023_16_WAS_NYJ,REG,16,NYJ,WAS,30,28,1,2
2023,2023_16_SEA_TEN,REG,16,TEN,SEA,17,20,0,-3
2023,2023_16_JAX_TB,REG,16,TB,JAX,30,12,1,18
2023,2023_16_ARI_CHI,REG,16,CHI,ARI,27,16,1,11
2023,2023_16_DAL_MIA,REG,16,MIA,DAL,22,20,1,2
2023,2023_16_NE_DEN,REG,16,DEN,NE,23,26,0,-3
2023,2023_16_LV_KC,REG,16,KC,LV,14,20,0,-6
2023,2023_16_NYG_PHI,REG,16,PHI,NYG,33,25,1,8
2023,2023_16_BAL_SF,REG,16,SF,BAL,19,33,0,-14
2023,2023_17_NYJ_CLE,REG,17,CLE,NYJ,37,20,1,17
2023,2023_17_DET_DAL,REG,17,DAL,DET,20,19,1,1
2023,2023_17_MIA_BAL,REG,17,BAL,MIA,56,19,1,37
2023,2023_17_NE_BUF,REG,17,BUF,NE,27,21,1,6
2023,2023_17_ATL_CHI,REG,17,CHI,ATL,37,17,1,20
2023,2023_17_TEN_HOU,REG,17,HOU,TEN,26,3,1,23
2023,2023_17_LV_IND,REG,17,IND,LV,23,20,1,3
2023,2023_17_CAR_JAX,REG,17,JAX,CAR,26,0,1,26
2023,2023_17_LA_NYG,REG,17,NYG,LA,25,26,0,-1
2023,2023_17_ARI_PHI,REG,17,PHI,ARI,31,35,0,-4
2023,2023_17_NO_TB,REG,17,TB,NO,13,23,0,-10
2023,2023_17_SF_WAS,REG,17,WAS,SF,10,27,0,-17
2023,2023_17_PIT_SEA,REG,17,SEA,PIT,23,30,0,-7
2023,2023_17_LAC_DEN,REG,17,DEN,LAC,16,9,1,7
2023,2023_17_CIN_KC,REG,17,KC,CIN,25,17,1,8
2023,2023_17_GB_MIN,REG,17,MIN,GB,10,33,0,-23
2023,2023_18_PIT_BAL,REG,18,BAL,PIT,10,17,0,-7
2023,2023_18_HOU_IND,REG,18,IND,HOU,19,23,0,-4
2023,2023_18_TB_CAR,REG,18,CAR,TB,0,9,0,-9
2023,2023_18_CLE_CIN,REG,18,CIN,CLE,31,14,1,17
2023,2023_18_MIN_DET,REG,18,DET,MIN,30,20,1,10
2023,2023_18_NYJ_NE,REG,18,NE,NYJ,3,17,0,-14
2023,2023_18_ATL_NO,REG,18,NO,ATL,48,17,1,31
2023,2023_18_JAX_TEN,REG,18,TEN,JAX,28,20,1,8
2023,2023_18_SEA_ARI,REG,18,ARI,SEA,20,21,0,-1
2023,2023_18_CHI_GB,REG,18,GB,CHI,17,9,1,8
2023,2023_18_KC_LAC,REG,18,LAC,KC,12,13,0,-1
2023,2023_18_DEN_LV,REG,18,LV,DEN,27,14,1,13
2023,2023_18_PHI_NYG,REG,18,NYG,PHI,27,10,1,17
2023,2023_18_LA_SF,REG,18,SF,LA,20,21,0,-1
2023,2023_18_DAL_WAS,REG,18,WAS,DAL,10,38,0,-28
2023,2023_18_BUF_MIA,REG,18,MIA,BUF,14,21,0,-7
2023,2023_19_CLE_HOU,WC,19,HOU,CLE,45,14,1,31
2023,2023_19_MIA_KC,WC,19,KC,MIA,26,7,1,19
2023,2023_19_GB_DAL,WC,19,DAL,GB,32,48,0,-16
2023,2023_19_LA_DET,WC,19,DET,LA,24,23,1,1
2023,2023_19_PIT_BUF,WC,19,BUF,PIT,31,17,1,14
2023,2023_19_PHI_TB,WC,19,TB,PHI,32,9,1,23
2023,2023_20_HOU_BAL,DIV,20,BAL,HOU,34,10,1,24
2023,2023_20_GB_SF,DIV,20,SF,GB,24,21,1,3
2023,2023_20_TB_DET,DIV,20,DET,TB,31,23,1,8
2023,2023_20_KC_BUF,DIV,20,BUF,KC,24,27,0,-3
2023,2023_21_KC_BAL,CON,21,BAL,KC,10,17,0,-7
2023,2023_21_DET_SF,CON,21,SF,DET,34,31,1,3
2023,2023_22_SF_KC,SB,22,KC,SF,25,22,1,3
